,NAME,State,Total Population 16 to 19 Years,Total_Male_Dropout,Total_Female_Dropout,Total_Dropout,County
0,Adams County,Illinois,3235,85,26,111,Adams 
1,Alexander County,Illinois,331,0,15,15,Alexander 
2,Bond County,Illinois,837,29,2,31,Bond 
3,Boone County,Illinois,3535,64,30,94,Boone 
4,Brown County,Illinois,244,0,0,0,Brown 
5,Bureau County,Illinois,1431,53,142,195,Bureau 
6,Calhoun County,Illinois,260,27,0,27,Calhoun 
7,Carroll County,Illinois,541,38,60,98,Carroll 
8,Cass County,Illinois,629,50,40,90,Cass 
9,Champaign County,Illinois,18988,297,152,449,Champaign 
10,Christian County,Illinois,1313,68,20,88,Christian 
11,Clark County,Illinois,704,14,71,85,Clark 
12,Clay County,Illinois,557,54,87,141,Clay 
13,Clinton County,Illinois,1787,47,15,62,Clinton 
14,Coles County,Illinois,3570,58,43,101,Coles 
15,Cook County,Illinois,247909,6757,4602,11359,Cook 
16,Crawford County,Illinois,791,149,14,163,Crawford 
17,Cumberland County,Illinois,485,122,6,128,Cumberland 
18,DeKalb County,Illinois,7653,142,60,202,DeKalb 
19,De Witt County,Illinois,821,16,59,75,De Witt 
20,Douglas County,Illinois,1078,306,96,402,Douglas 
21,DuPage County,Illinois,48112,615,912,1527,DuPage 
22,Edgar County,Illinois,862,15,14,29,Edgar 
23,Edwards County,Illinois,374,26,53,79,Edwards 
24,Effingham County,Illinois,1551,176,4,180,Effingham 
25,Fayette County,Illinois,959,86,71,157,Fayette 
26,Ford County,Illinois,615,22,39,61,Ford 
27,Franklin County,Illinois,1697,99,119,218,Franklin 
28,Fulton County,Illinois,1599,42,20,62,Fulton 
29,Gallatin County,Illinois,229,16,0,16,Gallatin 
30,Greene County,Illinois,680,24,5,29,Greene 
31,Grundy County,Illinois,2707,57,136,193,Grundy 
32,Hamilton County,Illinois,303,75,0,75,Hamilton 
33,Hancock County,Illinois,797,83,6,89,Hancock 
34,Hardin County,Illinois,132,18,0,18,Hardin 
35,Henderson County,Illinois,210,4,3,7,Henderson 
36,Henry County,Illinois,2498,34,20,54,Henry 
37,Iroquois County,Illinois,1359,8,2,10,Iroquois 
38,Jackson County,Illinois,4557,89,132,221,Jackson 
39,Jasper County,Illinois,362,1,0,1,Jasper 
40,Jefferson County,Illinois,1713,198,30,228,Jefferson 
41,Jersey County,Illinois,1326,96,0,96,Jersey 
42,Jo Daviess County,Illinois,856,0,0,0,Jo Daviess 
43,Johnson County,Illinois,529,17,8,25,Johnson 
44,Kane County,Illinois,30918,742,644,1386,Kane 
45,Kankakee County,Illinois,6868,215,256,471,Kankakee 
46,Kendall County,Illinois,7170,178,170,348,Kendall 
47,Knox County,Illinois,2738,66,76,142,Knox 
48,Lake County,Illinois,43241,762,1124,1886,Lake 
49,LaSalle County,Illinois,5313,280,131,411,LaSalle 
50,Lawrence County,Illinois,558,166,69,235,Lawrence 
51,Lee County,Illinois,1323,31,36,67,Lee 
52,Livingston County,Illinois,1859,30,19,49,Livingston 
53,Logan County,Illinois,1602,48,72,120,Logan 
54,McDonough County,Illinois,2905,49,129,178,McDonough 
55,McHenry County,Illinois,16929,409,209,618,McHenry 
56,McLean County,Illinois,12891,153,305,458,McLean 
57,Macon County,Illinois,5137,305,287,592,Macon 
58,Macoupin County,Illinois,2246,11,57,68,Macoupin 
59,Madison County,Illinois,12656,507,131,638,Madison 
60,Marion County,Illinois,1619,56,48,104,Marion 
61,Marshall County,Illinois,529,5,31,36,Marshall 
62,Mason County,Illinois,643,0,0,0,Mason 
63,Massac County,Illinois,592,29,37,66,Massac 
64,Menard County,Illinois,581,0,17,17,Menard 
65,Mercer County,Illinois,724,55,3,58,Mercer 
66,Monroe County,Illinois,1577,7,10,17,Monroe 
67,Montgomery County,Illinois,1197,32,84,116,Montgomery 
68,Morgan County,Illinois,1978,32,18,50,Morgan 
69,Moultrie County,Illinois,794,222,81,303,Moultrie 
70,Ogle County,Illinois,2514,27,52,79,Ogle 
71,Peoria County,Illinois,9171,279,119,398,Peoria 
72,Perry County,Illinois,955,99,4,103,Perry 
73,Piatt County,Illinois,790,48,34,82,Piatt 
74,Pike County,Illinois,649,12,1,13,Pike 
75,Pope County,Illinois,99,3,20,23,Pope 
76,Pulaski County,Illinois,355,13,5,18,Pulaski 
77,Putnam County,Illinois,271,10,0,10,Putnam 
78,Randolph County,Illinois,1463,18,49,67,Randolph 
79,Richland County,Illinois,719,31,2,33,Richland 
80,Rock Island County,Illinois,7450,234,169,403,Rock Island 
81,St. Clair County,Illinois,12734,581,388,969,St. Clair 
82,Saline County,Illinois,1025,120,19,139,Saline 
83,Sangamon County,Illinois,9520,354,111,465,Sangamon 
84,Schuyler County,Illinois,425,0,23,23,Schuyler 
85,Scott County,Illinois,240,2,7,9,Scott 
86,Shelby County,Illinois,971,32,36,68,Shelby 
87,Stark County,Illinois,223,14,6,20,Stark 
88,Stephenson County,Illinois,1907,18,108,126,Stephenson 
89,Tazewell County,Illinois,6145,298,176,474,Tazewell 
90,Union County,Illinois,791,25,20,45,Union 
91,Vermilion County,Illinois,3678,154,170,324,Vermilion 
92,Wabash County,Illinois,465,27,26,53,Wabash 
93,Warren County,Illinois,1199,5,5,10,Warren 
94,Washington County,Illinois,629,9,11,20,Washington 
95,Wayne County,Illinois,731,79,78,157,Wayne 
96,White County,Illinois,538,12,6,18,White 
97,Whiteside County,Illinois,2795,49,156,205,Whiteside 
98,Will County,Illinois,39887,1052,742,1794,Will 
99,Williamson County,Illinois,2632,64,50,114,Williamson 
100,Winnebago County,Illinois,14236,535,727,1262,Winnebago 
101,Woodford County,Illinois,2108,26,18,44,Woodford 
0,Adair County,Oklahoma,1212,97,65,162,Adair 
1,Alfalfa County,Oklahoma,188,12,0,12,Alfalfa 
2,Atoka County,Oklahoma,662,18,20,38,Atoka 
3,Beaver County,Oklahoma,240,12,7,19,Beaver 
4,Beckham County,Oklahoma,1159,26,0,26,Beckham 
5,Blaine County,Oklahoma,366,30,0,30,Blaine 
6,Bryan County,Oklahoma,2643,115,80,195,Bryan 
7,Caddo County,Oklahoma,1483,136,24,160,Caddo 
8,Canadian County,Oklahoma,7407,205,81,286,Canadian 
9,Carter County,Oklahoma,2340,184,81,265,Carter 
10,Cherokee County,Oklahoma,3077,117,55,172,Cherokee 
11,Choctaw County,Oklahoma,693,30,47,77,Choctaw 
12,Cimarron County,Oklahoma,71,0,0,0,Cimarron 
13,Cleveland County,Oklahoma,16887,269,128,397,Cleveland 
14,Coal County,Oklahoma,271,36,0,36,Coal 
15,Comanche County,Oklahoma,7426,164,270,434,Comanche 
16,Cotton County,Oklahoma,330,15,0,15,Cotton 
17,Craig County,Oklahoma,728,102,8,110,Craig 
18,Creek County,Oklahoma,3598,206,90,296,Creek 
19,Custer County,Oklahoma,2076,1,8,9,Custer 
20,Delaware County,Oklahoma,2009,154,60,214,Delaware 
21,Dewey County,Oklahoma,299,5,0,5,Dewey 
22,Ellis County,Oklahoma,213,15,6,21,Ellis 
23,Garfield County,Oklahoma,3103,111,108,219,Garfield 
24,Garvin County,Oklahoma,1548,123,58,181,Garvin 
25,Grady County,Oklahoma,3019,105,50,155,Grady 
26,Grant County,Oklahoma,211,5,0,5,Grant 
27,Greer County,Oklahoma,181,33,0,33,Greer 
28,Harmon County,Oklahoma,128,34,0,34,Harmon 
29,Harper County,Oklahoma,136,0,13,13,Harper 
30,Haskell County,Oklahoma,642,48,14,62,Haskell 
31,Hughes County,Oklahoma,559,11,12,23,Hughes 
32,Jackson County,Oklahoma,1249,8,0,8,Jackson 
33,Jefferson County,Oklahoma,346,20,14,34,Jefferson 
34,Johnston County,Oklahoma,595,8,6,14,Johnston 
35,Kay County,Oklahoma,2322,159,81,240,Kay 
36,Kingfisher County,Oklahoma,712,95,60,155,Kingfisher 
37,Kiowa County,Oklahoma,359,2,0,2,Kiowa 
38,Latimer County,Oklahoma,614,1,27,28,Latimer 
39,Le Flore County,Oklahoma,2621,87,83,170,Le Flore 
40,Lincoln County,Oklahoma,1909,148,49,197,Lincoln 
41,Logan County,Oklahoma,2854,44,31,75,Logan 
42,Love County,Oklahoma,603,33,0,33,Love 
43,McClain County,Oklahoma,2169,6,4,10,McClain 
44,McCurtain County,Oklahoma,1500,73,84,157,McCurtain 
45,McIntosh County,Oklahoma,660,4,34,38,McIntosh 
46,Major County,Oklahoma,340,21,11,32,Major 
47,Marshall County,Oklahoma,830,93,21,114,Marshall 
48,Mayes County,Oklahoma,2111,219,155,374,Mayes 
49,Murray County,Oklahoma,610,73,28,101,Murray 
50,Muskogee County,Oklahoma,3507,276,119,395,Muskogee 
51,Noble County,Oklahoma,551,47,0,47,Noble 
52,Nowata County,Oklahoma,502,4,6,10,Nowata 
53,Okfuskee County,Oklahoma,544,42,53,95,Okfuskee 
54,Oklahoma County,Oklahoma,40152,2120,1189,3309,Oklahoma 
55,Okmulgee County,Oklahoma,2238,118,64,182,Okmulgee 
56,Osage County,Oklahoma,2259,116,39,155,Osage 
57,Ottawa County,Oklahoma,1956,47,65,112,Ottawa 
58,Pawnee County,Oklahoma,769,59,50,109,Pawnee 
59,Payne County,Oklahoma,7032,136,19,155,Payne 
60,Pittsburg County,Oklahoma,1921,166,82,248,Pittsburg 
61,Pontotoc County,Oklahoma,2221,91,31,122,Pontotoc 
62,Pottawatomie County,Oklahoma,4451,128,78,206,Pottawatomie 
63,Pushmataha County,Oklahoma,518,39,6,45,Pushmataha 
64,Roger Mills County,Oklahoma,160,34,0,34,Roger Mills 
65,Rogers County,Oklahoma,4838,130,117,247,Rogers 
66,Seminole County,Oklahoma,1392,83,15,98,Seminole 
67,Sequoyah County,Oklahoma,2186,179,32,211,Sequoyah 
68,Stephens County,Oklahoma,2078,135,12,147,Stephens 
69,Texas County,Oklahoma,1425,49,14,63,Texas 
70,Tillman County,Oklahoma,478,13,15,28,Tillman 
71,Tulsa County,Oklahoma,33058,1363,1298,2661,Tulsa 
72,Wagoner County,Oklahoma,3956,101,85,186,Wagoner 
73,Washington County,Oklahoma,2637,168,19,187,Washington 
74,Washita County,Oklahoma,653,21,11,32,Washita 
75,Woods County,Oklahoma,596,70,24,94,Woods 
76,Woodward County,Oklahoma,1066,34,21,55,Woodward 
0,Adams County,Wisconsin,668,18,14,32,Adams 
1,Ashland County,Wisconsin,986,26,51,77,Ashland 
2,Barron County,Wisconsin,1955,164,114,278,Barron 
3,Bayfield County,Wisconsin,556,19,6,25,Bayfield 
4,Brown County,Wisconsin,14078,403,144,547,Brown 
5,Buffalo County,Wisconsin,585,20,24,44,Buffalo 
6,Burnett County,Wisconsin,580,20,22,42,Burnett 
7,Calumet County,Wisconsin,2569,3,20,23,Calumet 
8,Chippewa County,Wisconsin,2738,120,72,192,Chippewa 
9,Clark County,Wisconsin,1935,527,361,888,Clark 
10,Columbia County,Wisconsin,2618,200,108,308,Columbia 
11,Crawford County,Wisconsin,745,38,31,69,Crawford 
12,Dane County,Wisconsin,29400,177,411,588,Dane 
13,Dodge County,Wisconsin,3769,259,14,273,Dodge 
14,Door County,Wisconsin,1008,46,77,123,Door 
15,Douglas County,Wisconsin,2190,51,46,97,Douglas 
16,Dunn County,Wisconsin,3570,53,12,65,Dunn 
17,Eau Claire County,Wisconsin,6920,193,112,305,Eau Claire 
18,Florence County,Wisconsin,120,0,3,3,Florence 
19,Fond du Lac County,Wisconsin,5232,55,67,122,Fond du Lac 
20,Forest County,Wisconsin,438,4,7,11,Forest 
21,Grant County,Wisconsin,4089,181,85,266,Grant 
22,Green County,Wisconsin,1651,28,6,34,Green 
23,Green Lake County,Wisconsin,958,91,49,140,Green Lake 
24,Iowa County,Wisconsin,1021,23,8,31,Iowa 
25,Iron County,Wisconsin,174,0,0,0,Iron 
26,Jackson County,Wisconsin,957,16,17,33,Jackson 
27,Jefferson County,Wisconsin,5408,224,0,224,Jefferson 
28,Juneau County,Wisconsin,1112,60,3,63,Juneau 
29,Kenosha County,Wisconsin,9679,303,235,538,Kenosha 
30,Kewaunee County,Wisconsin,924,23,10,33,Kewaunee 
31,La Crosse County,Wisconsin,7626,59,63,122,La Crosse 
32,Lafayette County,Wisconsin,897,67,29,96,Lafayette 
33,Langlade County,Wisconsin,984,139,30,169,Langlade 
34,Lincoln County,Wisconsin,1334,30,50,80,Lincoln 
35,Manitowoc County,Wisconsin,3864,73,64,137,Manitowoc 
36,Marathon County,Wisconsin,6558,265,132,397,Marathon 
37,Marinette County,Wisconsin,1770,34,10,44,Marinette 
38,Marquette County,Wisconsin,639,12,45,57,Marquette 
39,Menominee County,Wisconsin,303,0,0,0,Menominee 
40,Milwaukee County,Wisconsin,49973,1765,1050,2815,Milwaukee 
41,Monroe County,Wisconsin,2294,180,121,301,Monroe 
42,Oconto County,Wisconsin,1694,79,11,90,Oconto 
43,Oneida County,Wisconsin,1311,25,0,25,Oneida 
44,Outagamie County,Wisconsin,9475,66,102,168,Outagamie 
45,Ozaukee County,Wisconsin,4939,80,49,129,Ozaukee 
46,Pepin County,Wisconsin,282,23,29,52,Pepin 
47,Pierce County,Wisconsin,3281,46,35,81,Pierce 
48,Polk County,Wisconsin,1973,51,33,84,Polk 
49,Portage County,Wisconsin,4883,183,9,192,Portage 
50,Price County,Wisconsin,513,3,11,14,Price 
51,Racine County,Wisconsin,9902,379,738,1117,Racine 
52,Richland County,Wisconsin,847,124,35,159,Richland 
53,Rock County,Wisconsin,8110,385,22,407,Rock 
54,Rusk County,Wisconsin,546,52,43,95,Rusk 
55,St. Croix County,Wisconsin,4617,79,11,90,St. Croix 
56,Sauk County,Wisconsin,3137,209,246,455,Sauk 
57,Sawyer County,Wisconsin,554,42,28,70,Sawyer 
58,Shawano County,Wisconsin,2001,48,65,113,Shawano 
59,Sheboygan County,Wisconsin,5582,122,27,149,Sheboygan 
60,Taylor County,Wisconsin,1053,83,9,92,Taylor 
61,Trempealeau County,Wisconsin,1385,80,47,127,Trempealeau 
62,Vernon County,Wisconsin,1610,159,130,289,Vernon 
63,Vilas County,Wisconsin,667,32,58,90,Vilas 
64,Walworth County,Wisconsin,6204,74,141,215,Walworth 
65,Washburn County,Wisconsin,629,19,12,31,Washburn 
66,Washington County,Wisconsin,6878,141,140,281,Washington 
67,Waukesha County,Wisconsin,21071,174,85,259,Waukesha 
68,Waupaca County,Wisconsin,2338,49,118,167,Waupaca 
69,Waushara County,Wisconsin,951,113,28,141,Waushara 
70,Winnebago County,Wisconsin,9425,389,84,473,Winnebago 
71,Wood County,Wisconsin,3134,38,49,87,Wood 
0,Androscoggin County,Maine,5450,184,182,366,Androscoggin 
1,Aroostook County,Maine,3172,120,29,149,Aroostook 
2,Cumberland County,Maine,14030,156,166,322,Cumberland 
3,Franklin County,Maine,1680,41,27,68,Franklin 
4,Hancock County,Maine,2050,5,30,35,Hancock 
5,Kennebec County,Maine,6078,337,51,388,Kennebec 
6,Knox County,Maine,1562,172,51,223,Knox 
7,Lincoln County,Maine,1226,59,80,139,Lincoln 
8,Oxford County,Maine,2579,70,196,266,Oxford 
9,Penobscot County,Maine,8892,147,124,271,Penobscot 
10,Piscataquis County,Maine,795,9,11,20,Piscataquis 
11,Sagadahoc County,Maine,1387,36,0,36,Sagadahoc 
12,Somerset County,Maine,2149,61,29,90,Somerset 
13,Waldo County,Maine,1784,21,249,270,Waldo 
14,Washington County,Maine,1445,48,18,66,Washington 
15,York County,Maine,8997,156,295,451,York 
0,Adams County,Pennsylvania,5416,148,93,241,Adams 
1,Allegheny County,Pennsylvania,56946,1093,836,1929,Allegheny 
2,Armstrong County,Pennsylvania,2825,64,89,153,Armstrong 
3,Beaver County,Pennsylvania,6908,109,73,182,Beaver 
4,Bedford County,Pennsylvania,2225,115,102,217,Bedford 
5,Berks County,Pennsylvania,23935,851,662,1513,Berks 
6,Blair County,Pennsylvania,6207,401,206,607,Blair 
7,Bradford County,Pennsylvania,2789,70,106,176,Bradford 
8,Bucks County,Pennsylvania,30623,516,690,1206,Bucks 
9,Butler County,Pennsylvania,9842,131,89,220,Butler 
10,Cambria County,Pennsylvania,6824,118,69,187,Cambria 
11,Cameron County,Pennsylvania,142,0,4,4,Cameron 
12,Carbon County,Pennsylvania,2647,242,110,352,Carbon 
13,Centre County,Pennsylvania,14510,318,301,619,Centre 
14,Chester County,Pennsylvania,29123,574,353,927,Chester 
15,Clarion County,Pennsylvania,2381,162,85,247,Clarion 
16,Clearfield County,Pennsylvania,3093,130,43,173,Clearfield 
17,Clinton County,Pennsylvania,2386,263,264,527,Clinton 
18,Columbia County,Pennsylvania,4399,128,91,219,Columbia 
19,Crawford County,Pennsylvania,4593,429,263,692,Crawford 
20,Cumberland County,Pennsylvania,13393,412,323,735,Cumberland 
21,Dauphin County,Pennsylvania,13073,964,458,1422,Dauphin 
22,Delaware County,Pennsylvania,31626,795,387,1182,Delaware 
23,Elk County,Pennsylvania,1268,52,0,52,Elk 
24,Erie County,Pennsylvania,15315,626,194,820,Erie 
25,Fayette County,Pennsylvania,5535,209,109,318,Fayette 
26,Forest County,Pennsylvania,255,8,0,8,Forest 
27,Franklin County,Pennsylvania,8090,584,359,943,Franklin 
28,Fulton County,Pennsylvania,604,5,3,8,Fulton 
29,Greene County,Pennsylvania,1948,50,15,65,Greene 
30,Huntingdon County,Pennsylvania,2349,100,45,145,Huntingdon 
31,Indiana County,Pennsylvania,6235,614,201,815,Indiana 
32,Jefferson County,Pennsylvania,2006,116,200,316,Jefferson 
33,Juniata County,Pennsylvania,1237,47,116,163,Juniata 
34,Lackawanna County,Pennsylvania,10977,403,268,671,Lackawanna 
35,Lancaster County,Pennsylvania,28051,3765,3073,6838,Lancaster 
36,Lawrence County,Pennsylvania,4359,163,50,213,Lawrence 
37,Lebanon County,Pennsylvania,6930,364,380,744,Lebanon 
38,Lehigh County,Pennsylvania,19919,468,282,750,Lehigh 
39,Luzerne County,Pennsylvania,15497,654,372,1026,Luzerne 
40,Lycoming County,Pennsylvania,6069,102,419,521,Lycoming 
41,McKean County,Pennsylvania,2251,9,3,12,McKean 
42,Mercer County,Pennsylvania,6342,307,180,487,Mercer 
43,Mifflin County,Pennsylvania,2126,459,172,631,Mifflin 
44,Monroe County,Pennsylvania,10254,26,186,212,Monroe 
45,Montgomery County,Pennsylvania,39786,691,405,1096,Montgomery 
46,Montour County,Pennsylvania,819,48,13,61,Montour 
47,Northampton County,Pennsylvania,17592,378,321,699,Northampton 
48,Northumberland County,Pennsylvania,3799,319,100,419,Northumberland 
49,Perry County,Pennsylvania,2100,325,174,499,Perry 
50,Philadelphia County,Pennsylvania,78270,2371,1469,3840,Philadelphia 
51,Pike County,Pennsylvania,2637,13,51,64,Pike 
52,Potter County,Pennsylvania,742,38,0,38,Potter 
53,Schuylkill County,Pennsylvania,5966,139,145,284,Schuylkill 
54,Snyder County,Pennsylvania,2842,185,147,332,Snyder 
55,Somerset County,Pennsylvania,2763,125,167,292,Somerset 
56,Sullivan County,Pennsylvania,244,14,0,14,Sullivan 
57,Susquehanna County,Pennsylvania,1664,51,27,78,Susquehanna 
58,Tioga County,Pennsylvania,2229,95,25,120,Tioga 
59,Union County,Pennsylvania,3705,357,264,621,Union 
60,Venango County,Pennsylvania,2284,208,121,329,Venango 
61,Warren County,Pennsylvania,1801,40,29,69,Warren 
62,Washington County,Pennsylvania,10169,292,144,436,Washington 
63,Wayne County,Pennsylvania,1986,60,159,219,Wayne 
64,Westmoreland County,Pennsylvania,15517,93,317,410,Westmoreland 
65,Wyoming County,Pennsylvania,1372,20,31,51,Wyoming 
66,York County,Pennsylvania,22389,853,629,1482,York 
0,Barnstable County,Massachusetts,8440,109,163,272,Barnstable 
1,Berkshire County,Massachusetts,6497,140,41,181,Berkshire 
2,Bristol County,Massachusetts,28764,1405,708,2113,Bristol 
3,Dukes County,Massachusetts,937,9,0,9,Dukes 
4,Essex County,Massachusetts,41801,1296,576,1872,Essex 
5,Franklin County,Massachusetts,3042,54,68,122,Franklin 
6,Hampden County,Massachusetts,26372,855,594,1449,Hampden 
7,Hampshire County,Massachusetts,16924,198,170,368,Hampshire 
8,Middlesex County,Massachusetts,83637,1183,798,1981,Middlesex 
9,Nantucket County,Massachusetts,459,0,9,9,Nantucket 
10,Norfolk County,Massachusetts,36571,462,274,736,Norfolk 
11,Plymouth County,Massachusetts,27454,648,210,858,Plymouth 
12,Suffolk County,Massachusetts,47361,1391,442,1833,Suffolk 
13,Worcester County,Massachusetts,46044,1080,615,1695,Worcester 
0,Adams County,Ohio,1435,68,75,143,Adams 
1,Allen County,Ohio,5798,269,117,386,Allen 
2,Ashland County,Ohio,3400,124,92,216,Ashland 
3,Ashtabula County,Ohio,4494,243,316,559,Ashtabula 
4,Athens County,Ohio,8342,66,41,107,Athens 
5,Auglaize County,Ohio,2299,0,122,122,Auglaize 
6,Belmont County,Ohio,2876,59,51,110,Belmont 
7,Brown County,Ohio,2146,89,142,231,Brown 
8,Butler County,Ohio,24365,357,384,741,Butler 
9,Carroll County,Ohio,1402,157,54,211,Carroll 
10,Champaign County,Ohio,2106,177,38,215,Champaign 
11,Clark County,Ohio,7401,247,256,503,Clark 
12,Clermont County,Ohio,9865,376,68,444,Clermont 
13,Clinton County,Ohio,2228,51,48,99,Clinton 
14,Columbiana County,Ohio,4746,386,195,581,Columbiana 
15,Coshocton County,Ohio,1646,274,179,453,Coshocton 
16,Crawford County,Ohio,1825,60,81,141,Crawford 
17,Cuyahoga County,Ohio,59941,1464,1222,2686,Cuyahoga 
18,Darke County,Ohio,2454,51,10,61,Darke 
19,Defiance County,Ohio,2155,16,0,16,Defiance 
20,Delaware County,Ohio,11776,66,131,197,Delaware 
21,Erie County,Ohio,3499,109,122,231,Erie 
22,Fairfield County,Ohio,8330,99,46,145,Fairfield 
23,Fayette County,Ohio,1341,13,23,36,Fayette 
24,Franklin County,Ohio,67570,2401,1228,3629,Franklin 
25,Fulton County,Ohio,2228,71,170,241,Fulton 
26,Gallia County,Ohio,1554,247,36,283,Gallia 
27,Geauga County,Ohio,5380,729,638,1367,Geauga 
28,Greene County,Ohio,10974,266,54,320,Greene 
29,Guernsey County,Ohio,2119,80,38,118,Guernsey 
30,Hamilton County,Ohio,43158,1473,1679,3152,Hamilton 
31,Hancock County,Ohio,4056,97,60,157,Hancock 
32,Hardin County,Ohio,2503,52,39,91,Hardin 
33,Harrison County,Ohio,774,111,23,134,Harrison 
34,Henry County,Ohio,1404,39,82,121,Henry 
35,Highland County,Ohio,2308,400,171,571,Highland 
36,Hocking County,Ohio,1468,73,4,77,Hocking 
37,Holmes County,Ohio,2887,1522,1495,3017,Holmes 
38,Huron County,Ohio,2944,118,83,201,Huron 
39,Jackson County,Ohio,1390,0,40,40,Jackson 
40,Jefferson County,Ohio,3115,43,41,84,Jefferson 
41,Knox County,Ohio,3974,147,66,213,Knox 
42,Lake County,Ohio,11326,279,126,405,Lake 
43,Lawrence County,Ohio,2847,0,4,4,Lawrence 
44,Licking County,Ohio,9409,244,106,350,Licking 
45,Logan County,Ohio,2530,24,6,30,Logan 
46,Lorain County,Ohio,16474,552,493,1045,Lorain 
47,Lucas County,Ohio,21964,663,419,1082,Lucas 
48,Madison County,Ohio,1946,73,10,83,Madison 
49,Mahoning County,Ohio,11084,301,186,487,Mahoning 
50,Marion County,Ohio,2840,222,68,290,Marion 
51,Medina County,Ohio,9100,310,148,458,Medina 
52,Meigs County,Ohio,1089,84,15,99,Meigs 
53,Mercer County,Ohio,2270,26,0,26,Mercer 
54,Miami County,Ohio,5448,73,106,179,Miami 
55,Monroe County,Ohio,608,75,15,90,Monroe 
56,Montgomery County,Ohio,26769,477,330,807,Montgomery 
57,Morgan County,Ohio,739,4,0,4,Morgan 
58,Morrow County,Ohio,1931,98,263,361,Morrow 
59,Muskingum County,Ohio,4169,63,35,98,Muskingum 
60,Noble County,Ohio,345,2,0,2,Noble 
61,Ottawa County,Ohio,1818,0,81,81,Ottawa 
62,Paulding County,Ohio,943,23,31,54,Paulding 
63,Perry County,Ohio,1917,118,8,126,Perry 
64,Pickaway County,Ohio,3001,115,110,225,Pickaway 
65,Pike County,Ohio,1265,14,60,74,Pike 
66,Portage County,Ohio,11871,289,143,432,Portage 
67,Preble County,Ohio,2069,47,32,79,Preble 
68,Putnam County,Ohio,1724,36,3,39,Putnam 
69,Richland County,Ohio,5654,271,313,584,Richland 
70,Ross County,Ohio,3389,280,71,351,Ross 
71,Sandusky County,Ohio,3112,54,75,129,Sandusky 
72,Scioto County,Ohio,3934,0,121,121,Scioto 
73,Seneca County,Ohio,3705,86,13,99,Seneca 
74,Shelby County,Ohio,2621,32,34,66,Shelby 
75,Stark County,Ohio,18332,510,281,791,Stark 
76,Summit County,Ohio,26781,680,550,1230,Summit 
77,Trumbull County,Ohio,8862,815,479,1294,Trumbull 
78,Tuscarawas County,Ohio,4374,336,369,705,Tuscarawas 
79,Union County,Ohio,2770,32,69,101,Union 
80,Van Wert County,Ohio,1413,89,48,137,Van Wert 
81,Vinton County,Ohio,625,0,3,3,Vinton 
82,Warren County,Ohio,12795,142,176,318,Warren 
83,Washington County,Ohio,3050,0,56,56,Washington 
84,Wayne County,Ohio,6432,735,839,1574,Wayne 
85,Williams County,Ohio,1735,117,15,132,Williams 
86,Wood County,Ohio,10149,36,236,272,Wood 
87,Wyandot County,Ohio,1133,51,0,51,Wyandot 
0,Apache County,Arizona,4645,108,83,191,Apache 
1,Cochise County,Arizona,6049,119,73,192,Cochise 
2,Coconino County,Arizona,15472,137,80,217,Coconino 
3,Gila County,Arizona,1753,103,37,140,Gila 
4,Graham County,Arizona,2406,96,108,204,Graham 
5,Greenlee County,Arizona,638,12,0,12,Greenlee 
6,La Paz County,Arizona,690,42,0,42,La Paz 
7,Maricopa County,Arizona,236881,10186,7049,17235,Maricopa 
8,Mohave County,Arizona,7690,650,583,1233,Mohave 
9,Navajo County,Arizona,5842,268,277,545,Navajo 
10,Pima County,Arizona,56103,2198,1475,3673,Pima 
11,Pinal County,Arizona,21304,1446,815,2261,Pinal 
12,Santa Cruz County,Arizona,3087,218,18,236,Santa Cruz 
13,Yavapai County,Arizona,9149,608,57,665,Yavapai 
14,Yuma County,Arizona,12040,473,156,629,Yuma 
0,Baker County,Oregon,566,57,0,57,Baker 
1,Benton County,Oregon,8128,16,92,108,Benton 
2,Clackamas County,Oregon,19445,422,406,828,Clackamas 
3,Clatsop County,Oregon,1767,114,142,256,Clatsop 
4,Columbia County,Oregon,2471,80,25,105,Columbia 
5,Coos County,Oregon,2732,88,32,120,Coos 
6,Crook County,Oregon,857,138,11,149,Crook 
7,Curry County,Oregon,705,30,11,41,Curry 
8,Deschutes County,Oregon,7811,647,203,850,Deschutes 
9,Douglas County,Oregon,4717,172,279,451,Douglas 
10,Gilliam County,Oregon,65,0,0,0,Gilliam 
11,Grant County,Oregon,210,0,8,8,Grant 
12,Harney County,Oregon,222,30,0,30,Harney 
13,Hood River County,Oregon,1327,0,100,100,Hood River 
14,Jackson County,Oregon,9465,494,380,874,Jackson 
15,Jefferson County,Oregon,1076,124,52,176,Jefferson 
16,Josephine County,Oregon,3735,76,102,178,Josephine 
17,Klamath County,Oregon,3192,181,55,236,Klamath 
18,Lake County,Oregon,250,0,8,8,Lake 
19,Lane County,Oregon,20412,771,240,1011,Lane 
20,Lincoln County,Oregon,1781,38,48,86,Lincoln 
21,Linn County,Oregon,6006,205,102,307,Linn 
22,Malheur County,Oregon,1699,60,164,224,Malheur 
23,Marion County,Oregon,18597,761,441,1202,Marion 
24,Morrow County,Oregon,843,25,3,28,Morrow 
25,Multnomah County,Oregon,32291,1041,528,1569,Multnomah 
26,Polk County,Oregon,5511,430,447,877,Polk 
27,Sherman County,Oregon,127,2,2,4,Sherman 
28,Tillamook County,Oregon,973,58,50,108,Tillamook 
29,Umatilla County,Oregon,4294,95,77,172,Umatilla 
30,Union County,Oregon,1512,37,1,38,Union 
31,Wallowa County,Oregon,212,4,0,4,Wallowa 
32,Wasco County,Oregon,1113,18,69,87,Wasco 
33,Washington County,Oregon,27817,1189,300,1489,Washington 
34,Wheeler County,Oregon,34,0,0,0,Wheeler 
35,Yamhill County,Oregon,5829,124,299,423,Yamhill 
0,Albany County,Wyoming,2908,0,0,0,Albany 
1,Big Horn County,Wyoming,696,76,8,84,Big Horn 
2,Campbell County,Wyoming,2221,91,50,141,Campbell 
3,Carbon County,Wyoming,669,0,23,23,Carbon 
4,Converse County,Wyoming,781,19,17,36,Converse 
5,Crook County,Wyoming,411,19,0,19,Crook 
6,Fremont County,Wyoming,2021,163,40,203,Fremont 
7,Goshen County,Wyoming,813,14,0,14,Goshen 
8,Hot Springs County,Wyoming,162,9,0,9,Hot Springs 
9,Johnson County,Wyoming,235,0,0,0,Johnson 
10,Laramie County,Wyoming,4843,160,116,276,Laramie 
11,Lincoln County,Wyoming,1058,123,198,321,Lincoln 
12,Natrona County,Wyoming,4018,45,12,57,Natrona 
13,Niobrara County,Wyoming,113,0,0,0,Niobrara 
14,Park County,Wyoming,1508,15,0,15,Park 
15,Platte County,Wyoming,287,0,0,0,Platte 
16,Sheridan County,Wyoming,1442,23,0,23,Sheridan 
17,Sublette County,Wyoming,487,0,0,0,Sublette 
18,Sweetwater County,Wyoming,2423,4,80,84,Sweetwater 
19,Teton County,Wyoming,735,93,0,93,Teton 
20,Uinta County,Wyoming,1016,0,15,15,Uinta 
21,Washakie County,Wyoming,411,16,24,40,Washakie 
22,Weston County,Wyoming,359,5,28,33,Weston 
0,Acadia Parish,Louisiana,3377,72,158,230,Acadia Parish
1,Allen Parish,Louisiana,976,108,21,129,Allen Parish
2,Ascension Parish,Louisiana,6244,39,282,321,Ascension Parish
3,Assumption Parish,Louisiana,1198,163,0,163,Assumption Parish
4,Avoyelles Parish,Louisiana,2072,122,117,239,Avoyelles Parish
5,Beauregard Parish,Louisiana,1987,52,6,58,Beauregard Parish
6,Bienville Parish,Louisiana,422,0,8,8,Bienville Parish
7,Bossier Parish,Louisiana,6597,493,94,587,Bossier Parish
8,Caddo Parish,Louisiana,12259,328,149,477,Caddo Parish
9,Calcasieu Parish,Louisiana,9484,201,177,378,Calcasieu Parish
10,Caldwell Parish,Louisiana,319,0,8,8,Caldwell Parish
11,Cameron Parish,Louisiana,435,0,0,0,Cameron Parish
12,Catahoula Parish,Louisiana,243,26,10,36,Catahoula Parish
13,Claiborne Parish,Louisiana,658,21,9,30,Claiborne Parish
14,Concordia Parish,Louisiana,1016,22,0,22,Concordia Parish
15,De Soto Parish,Louisiana,1330,92,3,95,De Soto Parish
16,East Baton Rouge Parish,Louisiana,27175,524,522,1046,East Baton Rouge Parish
17,East Carroll Parish,Louisiana,298,88,68,156,East Carroll Parish
18,East Feliciana Parish,Louisiana,804,50,0,50,East Feliciana Parish
19,Evangeline Parish,Louisiana,1638,211,172,383,Evangeline Parish
20,Franklin Parish,Louisiana,745,88,16,104,Franklin Parish
21,Grant Parish,Louisiana,1048,90,16,106,Grant Parish
22,Iberia Parish,Louisiana,3584,85,113,198,Iberia Parish
23,Iberville Parish,Louisiana,1499,89,17,106,Iberville Parish
24,Jackson Parish,Louisiana,673,102,0,102,Jackson Parish
25,Jefferson Parish,Louisiana,18536,773,698,1471,Jefferson Parish
26,Jefferson Davis Parish,Louisiana,1408,26,98,124,Jefferson Davis Parish
27,Lafayette Parish,Louisiana,11724,416,239,655,Lafayette Parish
28,Lafourche Parish,Louisiana,5007,227,331,558,Lafourche Parish
29,LaSalle Parish,Louisiana,894,25,65,90,LaSalle Parish
30,Lincoln Parish,Louisiana,4393,68,39,107,Lincoln Parish
31,Livingston Parish,Louisiana,7574,520,130,650,Livingston Parish
32,Madison Parish,Louisiana,568,58,11,69,Madison Parish
33,Morehouse Parish,Louisiana,1303,38,79,117,Morehouse Parish
34,Natchitoches Parish,Louisiana,2684,88,73,161,Natchitoches Parish
35,Orleans Parish,Louisiana,17498,587,252,839,Orleans Parish
36,Ouachita Parish,Louisiana,8682,409,338,747,Ouachita Parish
37,Plaquemines Parish,Louisiana,1354,77,24,101,Plaquemines Parish
38,Pointe Coupee Parish,Louisiana,1095,31,0,31,Pointe Coupee Parish
39,Rapides Parish,Louisiana,7062,204,287,491,Rapides Parish
40,Red River Parish,Louisiana,362,12,0,12,Red River Parish
41,Richland Parish,Louisiana,926,1,10,11,Richland Parish
42,Sabine Parish,Louisiana,1230,32,13,45,Sabine Parish
43,St. Bernard Parish,Louisiana,2247,81,26,107,St. Bernard Parish
44,St. Charles Parish,Louisiana,2567,28,49,77,St. Charles Parish
45,St. Helena Parish,Louisiana,562,0,64,64,St. Helena Parish
46,St. James Parish,Louisiana,942,14,0,14,St. James Parish
47,St. John the Baptist Parish,Louisiana,2018,91,0,91,St. John the Baptist Parish
48,St. Landry Parish,Louisiana,4576,216,216,432,St. Landry Parish
49,St. Martin Parish,Louisiana,2652,227,44,271,St. Martin Parish
50,St. Mary Parish,Louisiana,2693,65,108,173,St. Mary Parish
51,St. Tammany Parish,Louisiana,12793,260,289,549,St. Tammany Parish
52,Tangipahoa Parish,Louisiana,7596,689,155,844,Tangipahoa Parish
53,Tensas Parish,Louisiana,234,0,12,12,Tensas Parish
54,Terrebonne Parish,Louisiana,5269,337,70,407,Terrebonne Parish
55,Union Parish,Louisiana,1223,16,54,70,Union Parish
56,Vermilion Parish,Louisiana,3086,46,307,353,Vermilion Parish
57,Vernon Parish,Louisiana,2656,35,60,95,Vernon Parish
58,Washington Parish,Louisiana,2261,117,90,207,Washington Parish
59,Webster Parish,Louisiana,2060,126,13,139,Webster Parish
60,West Baton Rouge Parish,Louisiana,1332,21,60,81,West Baton Rouge Parish
61,West Carroll Parish,Louisiana,637,100,47,147,West Carroll Parish
62,West Feliciana Parish,Louisiana,791,0,0,0,West Feliciana Parish
63,Winn Parish,Louisiana,607,79,34,113,Winn Parish
0,Hawaii County,Hawaii,8746,142,141,283,Hawaii 
1,Honolulu County,Hawaii,42455,744,769,1513,Honolulu 
2,Kalawao County,Hawaii,2,0,0,0,Kalawao 
3,Kauai County,Hawaii,3070,140,121,261,Kauai 
4,Maui County,Hawaii,6491,419,156,575,Maui 
0,Belknap County,New Hampshire,2751,50,29,79,Belknap 
1,Carroll County,New Hampshire,1945,70,0,70,Carroll 
2,Cheshire County,New Hampshire,4944,73,62,135,Cheshire 
3,Coos County,New Hampshire,1197,34,8,42,Coos 
4,Grafton County,New Hampshire,6466,102,123,225,Grafton 
5,Hillsborough County,New Hampshire,19887,403,287,690,Hillsborough 
6,Merrimack County,New Hampshire,7990,100,170,270,Merrimack 
7,Rockingham County,New Hampshire,13706,218,138,356,Rockingham 
8,Strafford County,New Hampshire,9127,130,19,149,Strafford 
9,Sullivan County,New Hampshire,1913,65,140,205,Sullivan 
0,Accomack County,Virginia,1379,10,43,53,Accomack 
1,Albemarle County,Virginia,8563,87,65,152,Albemarle 
2,Alleghany County,Virginia,652,16,20,36,Alleghany 
3,Amelia County,Virginia,752,20,0,20,Amelia 
4,Amherst County,Virginia,1531,0,52,52,Amherst 
5,Appomattox County,Virginia,837,0,54,54,Appomattox 
6,Arlington County,Virginia,7127,193,327,520,Arlington 
7,Augusta County,Virginia,3307,103,126,229,Augusta 
8,Bath County,Virginia,59,0,0,0,Bath 
9,Bedford County,Virginia,3459,97,26,123,Bedford 
10,Bland County,Virginia,264,32,0,32,Bland 
11,Botetourt County,Virginia,1593,86,7,93,Botetourt 
12,Brunswick County,Virginia,831,6,0,6,Brunswick 
13,Buchanan County,Virginia,973,16,104,120,Buchanan 
14,Buckingham County,Virginia,663,0,19,19,Buckingham 
15,Campbell County,Virginia,2559,77,8,85,Campbell 
16,Caroline County,Virginia,1336,37,0,37,Caroline 
17,Carroll County,Virginia,1262,23,4,27,Carroll 
18,Charles City County,Virginia,280,8,6,14,Charles City 
19,Charlotte County,Virginia,534,18,18,36,Charlotte 
20,Chesterfield County,Virginia,19744,551,303,854,Chesterfield 
21,Clarke County,Virginia,720,0,0,0,Clarke 
22,Craig County,Virginia,83,0,0,0,Craig 
23,Culpeper County,Virginia,2883,180,82,262,Culpeper 
24,Cumberland County,Virginia,713,0,0,0,Cumberland 
25,Dickenson County,Virginia,623,4,13,17,Dickenson 
26,Dinwiddie County,Virginia,1444,8,133,141,Dinwiddie 
27,Essex County,Virginia,635,0,0,0,Essex 
28,Fairfax County,Virginia,56507,1219,701,1920,Fairfax 
29,Fauquier County,Virginia,3400,0,73,73,Fauquier 
30,Floyd County,Virginia,759,0,0,0,Floyd 
31,Fluvanna County,Virginia,1254,431,34,465,Fluvanna 
32,Franklin County,Virginia,2869,80,88,168,Franklin 
33,Frederick County,Virginia,4378,18,90,108,Frederick 
34,Giles County,Virginia,626,29,36,65,Giles 
35,Gloucester County,Virginia,1488,0,62,62,Gloucester 
36,Goochland County,Virginia,1099,0,0,0,Goochland 
37,Grayson County,Virginia,495,12,0,12,Grayson 
38,Greene County,Virginia,853,36,0,36,Greene 
39,Greensville County,Virginia,267,0,0,0,Greensville 
40,Halifax County,Virginia,1709,27,96,123,Halifax 
41,Hanover County,Virginia,6102,26,41,67,Hanover 
42,Henrico County,Virginia,14886,133,166,299,Henrico 
43,Henry County,Virginia,2243,35,70,105,Henry 
44,Highland County,Virginia,45,0,0,0,Highland 
45,Isle of Wight County,Virginia,1797,0,0,0,Isle of Wight 
46,James City County,Virginia,3315,28,44,72,James City 
47,King and Queen County,Virginia,318,0,0,0,King and Queen 
48,King George County,Virginia,1337,88,13,101,King George 
49,King William County,Virginia,1046,16,0,16,King William 
50,Lancaster County,Virginia,644,0,1,1,Lancaster 
51,Lee County,Virginia,856,0,38,38,Lee 
52,Loudoun County,Virginia,22703,1331,95,1426,Loudoun 
53,Louisa County,Virginia,1369,132,2,134,Louisa 
54,Lunenburg County,Virginia,347,15,0,15,Lunenburg 
55,Madison County,Virginia,635,0,0,0,Madison 
56,Mathews County,Virginia,504,34,0,34,Mathews 
57,Mecklenburg County,Virginia,1334,0,0,0,Mecklenburg 
58,Middlesex County,Virginia,360,28,0,28,Middlesex 
59,Montgomery County,Virginia,12904,33,0,33,Montgomery 
60,Nelson County,Virginia,526,0,0,0,Nelson 
61,New Kent County,Virginia,931,35,0,35,New Kent 
62,Northampton County,Virginia,479,12,0,12,Northampton 
63,Northumberland County,Virginia,449,0,0,0,Northumberland 
64,Nottoway County,Virginia,556,13,18,31,Nottoway 
65,Orange County,Virginia,1782,97,0,97,Orange 
66,Page County,Virginia,904,0,17,17,Page 
67,Patrick County,Virginia,554,0,22,22,Patrick 
68,Pittsylvania County,Virginia,2577,88,132,220,Pittsylvania 
69,Powhatan County,Virginia,1383,5,0,5,Powhatan 
70,Prince Edward County,Virginia,3054,49,5,54,Prince Edward 
71,Prince George County,Virginia,1788,11,4,15,Prince George 
72,Prince William County,Virginia,25903,506,409,915,Prince William 
73,Pulaski County,Virginia,1467,74,0,74,Pulaski 
74,Rappahannock County,Virginia,281,0,0,0,Rappahannock 
75,Richmond County,Virginia,260,0,1,1,Richmond 
76,Roanoke County,Virginia,4504,18,35,53,Roanoke 
77,Rockbridge County,Virginia,1087,16,9,25,Rockbridge 
78,Rockingham County,Virginia,4445,78,19,97,Rockingham 
79,Russell County,Virginia,1199,55,3,58,Russell 
80,Scott County,Virginia,807,64,10,74,Scott 
81,Shenandoah County,Virginia,2157,0,21,21,Shenandoah 
82,Smyth County,Virginia,1356,44,0,44,Smyth 
83,Southampton County,Virginia,703,4,4,8,Southampton 
84,Spotsylvania County,Virginia,7162,99,15,114,Spotsylvania 
85,Stafford County,Virginia,8323,170,175,345,Stafford 
86,Surry County,Virginia,239,0,0,0,Surry 
87,Sussex County,Virginia,408,43,2,45,Sussex 
88,Tazewell County,Virginia,1715,81,86,167,Tazewell 
89,Warren County,Virginia,2054,0,45,45,Warren 
90,Washington County,Virginia,2619,91,147,238,Washington 
91,Westmoreland County,Virginia,532,0,0,0,Westmoreland 
92,Wise County,Virginia,1800,61,50,111,Wise 
93,Wythe County,Virginia,1383,39,64,103,Wythe 
94,York County,Virginia,3611,58,0,58,York 
95,Alexandria city,Virginia,4411,278,122,400,Alexandria city
96,Bristol city,Virginia,952,0,2,2,Bristol city
97,Buena Vista city,Virginia,525,58,0,58,Buena Vista city
98,Charlottesville city,Virginia,2572,61,39,100,Charlottesville city
99,Chesapeake city,Virginia,12333,202,174,376,Chesapeake city
100,Colonial Heights city,Virginia,687,11,0,11,Colonial Heights city
101,Covington city,Virginia,243,10,0,10,Covington city
102,Danville city,Virginia,1750,49,8,57,Danville city
103,Emporia city,Virginia,311,26,0,26,Emporia city
104,Fairfax city,Virginia,1124,0,11,11,Fairfax city
105,Falls Church city,Virginia,760,0,19,19,Falls Church city
106,Franklin city,Virginia,119,0,0,0,Franklin city
107,Fredericksburg city,Virginia,2135,37,0,37,Fredericksburg city
108,Galax city,Virginia,248,0,0,0,Galax city
109,Hampton city,Virginia,6771,51,29,80,Hampton city
110,Harrisonburg city,Virginia,8240,6,4,10,Harrisonburg city
111,Hopewell city,Virginia,1156,0,0,0,Hopewell city
112,Lexington city,Virginia,1765,0,0,0,Lexington city
113,Lynchburg city,Virginia,7920,72,40,112,Lynchburg city
114,Manassas city,Virginia,2278,69,32,101,Manassas city
115,Manassas Park city,Virginia,965,0,104,104,Manassas Park city
116,Martinsville city,Virginia,541,0,0,0,Martinsville city
117,Newport News city,Virginia,10070,97,71,168,Newport News city
118,Norfolk city,Virginia,14423,209,250,459,Norfolk city
119,Norton city,Virginia,203,116,0,116,Norton city
120,Petersburg city,Virginia,1226,37,22,59,Petersburg city
121,Poquoson city,Virginia,742,70,0,70,Poquoson city
122,Portsmouth city,Virginia,4218,194,41,235,Portsmouth city
123,Radford city,Virginia,2969,0,116,116,Radford city
124,Richmond city,Virginia,11988,118,188,306,Richmond city
125,Roanoke city,Virginia,3592,102,82,184,Roanoke city
126,Salem city,Virginia,1876,20,57,77,Salem city
127,Staunton city,Virginia,1027,0,20,20,Staunton city
128,Suffolk city,Virginia,4484,121,128,249,Suffolk city
129,Virginia Beach city,Virginia,21406,180,197,377,Virginia Beach city
130,Waynesboro city,Virginia,815,0,38,38,Waynesboro city
131,Williamsburg city,Virginia,3139,0,0,0,Williamsburg city
132,Winchester city,Virginia,2225,2,40,42,Winchester city
0,Albany County,New York,19917,432,213,645,Albany 
1,Allegany County,New York,4078,85,63,148,Allegany 
2,Bronx County,New York,76754,2708,2060,4768,Bronx 
3,Broome County,New York,12778,242,98,340,Broome 
4,Cattaraugus County,New York,4106,110,210,320,Cattaraugus 
5,Cayuga County,New York,3770,278,149,427,Cayuga 
6,Chautauqua County,New York,7297,438,168,606,Chautauqua 
7,Chemung County,New York,4091,275,138,413,Chemung 
8,Chenango County,New York,2134,80,191,271,Chenango 
9,Clinton County,New York,4981,19,14,33,Clinton 
10,Columbia County,New York,2367,214,51,265,Columbia 
11,Cortland County,New York,4073,28,50,78,Cortland 
12,Delaware County,New York,2822,97,53,150,Delaware 
13,Dutchess County,New York,17027,297,308,605,Dutchess 
14,Erie County,New York,46540,1107,774,1881,Erie 
15,Essex County,New York,1534,120,76,196,Essex 
16,Franklin County,New York,2682,256,73,329,Franklin 
17,Fulton County,New York,2243,87,123,210,Fulton 
18,Genesee County,New York,2546,102,94,196,Genesee 
19,Greene County,New York,1966,253,20,273,Greene 
20,Hamilton County,New York,194,0,6,6,Hamilton 
21,Herkimer County,New York,3279,295,83,378,Herkimer 
22,Jefferson County,New York,5124,299,127,426,Jefferson 
23,Kings County,New York,107178,2646,1639,4285,Kings 
24,Lewis County,New York,1256,18,16,34,Lewis 
25,Livingston County,New York,4514,130,16,146,Livingston 
26,Madison County,New York,5327,129,88,217,Madison 
27,Monroe County,New York,41177,765,993,1758,Monroe 
28,Montgomery County,New York,2416,65,195,260,Montgomery 
29,Nassau County,New York,68114,899,618,1517,Nassau 
30,New York County,New York,56678,937,724,1661,New York 
31,Niagara County,New York,10342,318,72,390,Niagara 
32,Oneida County,New York,11886,278,403,681,Oneida 
33,Onondaga County,New York,27295,855,411,1266,Onondaga 
34,Ontario County,New York,5703,81,48,129,Ontario 
35,Orange County,New York,23420,1181,311,1492,Orange 
36,Orleans County,New York,1924,71,80,151,Orleans 
37,Oswego County,New York,7690,226,231,457,Oswego 
38,Otsego County,New York,4730,80,149,229,Otsego 
39,Putnam County,New York,4783,84,53,137,Putnam 
40,Queens County,New York,91648,2419,1720,4139,Queens 
41,Rensselaer County,New York,9233,299,143,442,Rensselaer 
42,Richmond County,New York,22945,313,260,573,Richmond 
43,Rockland County,New York,18871,316,346,662,Rockland 
44,St. Lawrence County,New York,8622,589,421,1010,St. Lawrence 
45,Saratoga County,New York,11641,199,152,351,Saratoga 
46,Schenectady County,New York,7696,186,197,383,Schenectady 
47,Schoharie County,New York,2037,62,26,88,Schoharie 
48,Schuyler County,New York,736,19,21,40,Schuyler 
49,Seneca County,New York,1432,206,222,428,Seneca 
50,Steuben County,New York,4488,438,217,655,Steuben 
51,Suffolk County,New York,77622,1634,1228,2862,Suffolk 
52,Sullivan County,New York,3861,143,101,244,Sullivan 
53,Tioga County,New York,2273,130,1,131,Tioga 
54,Tompkins County,New York,11394,88,28,116,Tompkins 
55,Ulster County,New York,8829,173,88,261,Ulster 
56,Warren County,New York,2795,147,144,291,Warren 
57,Washington County,New York,2614,153,123,276,Washington 
58,Wayne County,New York,4209,107,169,276,Wayne 
59,Westchester County,New York,52257,1018,436,1454,Westchester 
60,Wyoming County,New York,1538,108,25,133,Wyoming 
61,Yates County,New York,1532,278,319,597,Yates 
0,Aurora County,South Dakota,161,7,11,18,Aurora 
1,Beadle County,South Dakota,762,50,2,52,Beadle 
2,Bennett County,South Dakota,253,0,0,0,Bennett 
3,Bon Homme County,South Dakota,225,37,0,37,Bon Homme 
4,Brookings County,South Dakota,3696,33,0,33,Brookings 
5,Brown County,South Dakota,2179,2,173,175,Brown 
6,Brule County,South Dakota,232,74,9,83,Brule 
7,Buffalo County,South Dakota,172,6,0,6,Buffalo 
8,Butte County,South Dakota,497,27,12,39,Butte 
9,Campbell County,South Dakota,58,0,0,0,Campbell 
10,Charles Mix County,South Dakota,560,58,55,113,Charles Mix 
11,Clark County,South Dakota,113,0,12,12,Clark 
12,Clay County,South Dakota,2157,32,3,35,Clay 
13,Codington County,South Dakota,1425,43,20,63,Codington 
14,Corson County,South Dakota,274,6,4,10,Corson 
15,Custer County,South Dakota,316,0,11,11,Custer 
16,Davison County,South Dakota,959,0,15,15,Davison 
17,Day County,South Dakota,233,6,0,6,Day 
18,Deuel County,South Dakota,182,0,0,0,Deuel 
19,Dewey County,South Dakota,353,30,27,57,Dewey 
20,Douglas County,South Dakota,116,0,28,28,Douglas 
21,Edmunds County,South Dakota,176,0,0,0,Edmunds 
22,Fall River County,South Dakota,268,0,24,24,Fall River 
23,Faulk County,South Dakota,56,0,0,0,Faulk 
24,Grant County,South Dakota,348,1,126,127,Grant 
25,Gregory County,South Dakota,174,7,13,20,Gregory 
26,Haakon County,South Dakota,61,4,0,4,Haakon 
27,Hamlin County,South Dakota,366,6,3,9,Hamlin 
28,Hand County,South Dakota,77,0,18,18,Hand 
29,Hanson County,South Dakota,247,32,0,32,Hanson 
30,Harding County,South Dakota,68,0,0,0,Harding 
31,Hughes County,South Dakota,726,5,5,10,Hughes 
32,Hutchinson County,South Dakota,382,0,93,93,Hutchinson 
33,Hyde County,South Dakota,70,0,0,0,Hyde 
34,Jackson County,South Dakota,198,33,19,52,Jackson 
35,Jerauld County,South Dakota,90,6,0,6,Jerauld 
36,Jones County,South Dakota,43,0,0,0,Jones 
37,Kingsbury County,South Dakota,179,8,8,16,Kingsbury 
38,Lake County,South Dakota,786,2,0,2,Lake 
39,Lawrence County,South Dakota,1631,56,42,98,Lawrence 
40,Lincoln County,South Dakota,2655,316,174,490,Lincoln 
41,Lyman County,South Dakota,193,11,6,17,Lyman 
42,McCook County,South Dakota,273,1,0,1,McCook 
43,McPherson County,South Dakota,81,0,0,0,McPherson 
44,Marshall County,South Dakota,240,4,0,4,Marshall 
45,Meade County,South Dakota,1278,54,28,82,Meade 
46,Mellette County,South Dakota,65,14,5,19,Mellette 
47,Miner County,South Dakota,84,0,0,0,Miner 
48,Minnehaha County,South Dakota,9812,621,202,823,Minnehaha 
49,Moody County,South Dakota,249,1,1,2,Moody 
50,Oglala Lakota County,South Dakota,1039,77,16,93,Oglala Lakota 
51,Pennington County,South Dakota,5402,93,111,204,Pennington 
52,Perkins County,South Dakota,142,0,0,0,Perkins 
53,Potter County,South Dakota,80,0,0,0,Potter 
54,Roberts County,South Dakota,491,22,26,48,Roberts 
55,Sanborn County,South Dakota,104,7,14,21,Sanborn 
56,Spink County,South Dakota,373,0,8,8,Spink 
57,Stanley County,South Dakota,112,0,0,0,Stanley 
58,Sully County,South Dakota,46,4,9,13,Sully 
59,Todd County,South Dakota,860,72,61,133,Todd 
60,Tripp County,South Dakota,330,14,0,14,Tripp 
61,Turner County,South Dakota,407,102,0,102,Turner 
62,Union County,South Dakota,705,30,28,58,Union 
63,Walworth County,South Dakota,251,26,0,26,Walworth 
64,Yankton County,South Dakota,1100,80,5,85,Yankton 
65,Ziebach County,South Dakota,190,11,5,16,Ziebach 
0,Allegany County,Maryland,4330,134,35,169,Allegany 
1,Anne Arundel County,Maryland,26103,855,257,1112,Anne Arundel 
2,Baltimore County,Maryland,42229,1195,978,2173,Baltimore 
3,Calvert County,Maryland,4733,68,0,68,Calvert 
4,Caroline County,Maryland,1781,19,85,104,Caroline 
5,Carroll County,Maryland,9191,60,59,119,Carroll 
6,Cecil County,Maryland,5028,69,115,184,Cecil 
7,Charles County,Maryland,8733,185,128,313,Charles 
8,Dorchester County,Maryland,1409,121,2,123,Dorchester 
9,Frederick County,Maryland,13182,312,231,543,Frederick 
10,Garrett County,Maryland,1439,14,46,60,Garrett 
11,Harford County,Maryland,12931,247,139,386,Harford 
12,Howard County,Maryland,16151,193,35,228,Howard 
13,Kent County,Maryland,1356,5,8,13,Kent 
14,Montgomery County,Maryland,49595,892,476,1368,Montgomery 
15,Prince George's County,Maryland,47507,1374,517,1891,Prince George's 
16,Queen Anne's County,Maryland,2190,50,39,89,Queen Anne's 
17,St. Mary's County,Maryland,6586,113,105,218,St. Mary's 
18,Somerset County,Maryland,1579,18,68,86,Somerset 
19,Talbot County,Maryland,1625,49,26,75,Talbot 
20,Washington County,Maryland,6731,339,122,461,Washington 
21,Wicomico County,Maryland,7848,259,140,399,Wicomico 
22,Worcester County,Maryland,1930,98,42,140,Worcester 
23,Baltimore city,Maryland,29083,877,612,1489,Baltimore city
0,Alameda County,California,75033,1277,1158,2435,Alameda 
1,Alpine County,California,27,0,0,0,Alpine 
2,Amador County,California,1526,23,64,87,Amador 
3,Butte County,California,13116,292,278,570,Butte 
4,Calaveras County,California,1887,8,0,8,Calaveras 
5,Colusa County,California,1341,0,5,5,Colusa 
6,Contra Costa County,California,57664,829,663,1492,Contra Costa 
7,Del Norte County,California,1146,34,34,68,Del Norte 
8,El Dorado County,California,8902,498,393,891,El Dorado 
9,Fresno County,California,57175,1758,1271,3029,Fresno 
10,Glenn County,California,1646,46,17,63,Glenn 
11,Humboldt County,California,7391,100,118,218,Humboldt 
12,Imperial County,California,11042,210,37,247,Imperial 
13,Inyo County,California,764,0,4,4,Inyo 
14,Kern County,California,51710,1550,1085,2635,Kern 
15,Kings County,California,8094,158,39,197,Kings 
16,Lake County,California,2680,153,0,153,Lake 
17,Lassen County,California,1006,56,10,66,Lassen 
18,Los Angeles County,California,506395,12293,7197,19490,Los Angeles 
19,Madera County,California,9165,149,113,262,Madera 
20,Marin County,California,11608,165,163,328,Marin 
21,Mariposa County,California,433,2,0,2,Mariposa 
22,Mendocino County,California,4210,71,67,138,Mendocino 
23,Merced County,California,18897,442,176,618,Merced 
24,Modoc County,California,334,11,0,11,Modoc 
25,Mono County,California,573,3,32,35,Mono 
26,Monterey County,California,24924,989,568,1557,Monterey 
27,Napa County,California,7464,144,220,364,Napa 
28,Nevada County,California,3956,12,38,50,Nevada 
29,Orange County,California,163987,2716,1480,4196,Orange 
30,Placer County,California,19030,387,242,629,Placer 
31,Plumas County,California,995,52,0,52,Plumas 
32,Riverside County,California,141863,2346,1214,3560,Riverside 
33,Sacramento County,California,74532,1521,811,2332,Sacramento 
34,San Benito County,California,3553,26,10,36,San Benito 
35,San Bernardino County,California,124735,2970,2157,5127,San Bernardino 
36,San Diego County,California,167498,2872,2206,5078,San Diego 
37,San Francisco County,California,25111,309,43,352,San Francisco 
38,San Joaquin County,California,44050,1282,650,1932,San Joaquin 
39,San Luis Obispo County,California,19356,168,216,384,San Luis Obispo 
40,San Mateo County,California,32591,462,348,810,San Mateo 
41,Santa Barbara County,California,32625,651,271,922,Santa Barbara 
42,Santa Clara County,California,91069,1043,783,1826,Santa Clara 
43,Santa Cruz County,California,19926,270,68,338,Santa Cruz 
44,Shasta County,California,8066,126,74,200,Shasta 
45,Sierra County,California,115,0,0,0,Sierra 
46,Siskiyou County,California,2037,36,5,41,Siskiyou 
47,Solano County,California,20934,568,333,901,Solano 
48,Sonoma County,California,23815,545,303,848,Sonoma 
49,Stanislaus County,California,30958,331,315,646,Stanislaus 
50,Sutter County,California,5144,109,77,186,Sutter 
51,Tehama County,California,2933,3,16,19,Tehama 
52,Trinity County,California,523,0,0,0,Trinity 
53,Tulare County,California,29748,764,326,1090,Tulare 
54,Tuolumne County,California,1879,0,26,26,Tuolumne 
55,Ventura County,California,44708,1075,552,1627,Ventura 
56,Yolo County,California,18567,418,108,526,Yolo 
57,Yuba County,California,3728,84,40,124,Yuba 
0,Adair County,Missouri,2538,42,84,126,Adair 
1,Andrew County,Missouri,919,0,1,1,Andrew 
2,Atchison County,Missouri,191,6,10,16,Atchison 
3,Audrain County,Missouri,1282,32,62,94,Audrain 
4,Barry County,Missouri,1816,302,26,328,Barry 
5,Barton County,Missouri,669,39,90,129,Barton 
6,Bates County,Missouri,841,49,67,116,Bates 
7,Benton County,Missouri,675,7,70,77,Benton 
8,Bollinger County,Missouri,667,60,0,60,Bollinger 
9,Boone County,Missouri,12783,131,149,280,Boone 
10,Buchanan County,Missouri,4739,373,216,589,Buchanan 
11,Butler County,Missouri,2254,122,112,234,Butler 
12,Caldwell County,Missouri,497,24,29,53,Caldwell 
13,Callaway County,Missouri,2583,26,77,103,Callaway 
14,Camden County,Missouri,1971,113,74,187,Camden 
15,Cape Girardeau County,Missouri,4625,44,214,258,Cape Girardeau 
16,Carroll County,Missouri,367,3,42,45,Carroll 
17,Carter County,Missouri,439,4,3,7,Carter 
18,Cass County,Missouri,5688,269,89,358,Cass 
19,Cedar County,Missouri,660,107,67,174,Cedar 
20,Chariton County,Missouri,342,79,53,132,Chariton 
21,Christian County,Missouri,4410,46,71,117,Christian 
22,Clark County,Missouri,226,14,0,14,Clark 
23,Clay County,Missouri,12379,230,287,517,Clay 
24,Clinton County,Missouri,1227,9,69,78,Clinton 
25,Cole County,Missouri,4001,106,63,169,Cole 
26,Cooper County,Missouri,889,18,2,20,Cooper 
27,Crawford County,Missouri,947,16,34,50,Crawford 
28,Dade County,Missouri,426,5,6,11,Dade 
29,Dallas County,Missouri,843,115,133,248,Dallas 
30,Daviess County,Missouri,475,70,126,196,Daviess 
31,DeKalb County,Missouri,462,29,3,32,DeKalb 
32,Dent County,Missouri,789,0,8,8,Dent 
33,Douglas County,Missouri,518,28,0,28,Douglas 
34,Dunklin County,Missouri,1626,19,45,64,Dunklin 
35,Franklin County,Missouri,5114,76,151,227,Franklin 
36,Gasconade County,Missouri,611,19,6,25,Gasconade 
37,Gentry County,Missouri,295,38,20,58,Gentry 
38,Greene County,Missouri,16211,512,766,1278,Greene 
39,Grundy County,Missouri,597,45,17,62,Grundy 
40,Harrison County,Missouri,404,15,6,21,Harrison 
41,Henry County,Missouri,1038,53,12,65,Henry 
42,Hickory County,Missouri,462,175,0,175,Hickory 
43,Holt County,Missouri,165,2,0,2,Holt 
44,Howard County,Missouri,683,158,0,158,Howard 
45,Howell County,Missouri,1935,121,98,219,Howell 
46,Iron County,Missouri,440,4,13,17,Iron 
47,Jackson County,Missouri,33210,1163,560,1723,Jackson 
48,Jasper County,Missouri,6233,106,89,195,Jasper 
49,Jefferson County,Missouri,10743,244,89,333,Jefferson 
50,Johnson County,Missouri,3740,109,235,344,Johnson 
51,Knox County,Missouri,273,82,70,152,Knox 
52,Laclede County,Missouri,1635,30,8,38,Laclede 
53,Lafayette County,Missouri,1651,59,6,65,Lafayette 
54,Lawrence County,Missouri,2024,257,160,417,Lawrence 
55,Lewis County,Missouri,806,2,29,31,Lewis 
56,Lincoln County,Missouri,3312,129,35,164,Lincoln 
57,Linn County,Missouri,620,61,1,62,Linn 
58,Livingston County,Missouri,562,12,0,12,Livingston 
59,McDonald County,Missouri,1199,16,59,75,McDonald 
60,Macon County,Missouri,762,11,20,31,Macon 
61,Madison County,Missouri,694,0,0,0,Madison 
62,Maries County,Missouri,441,0,15,15,Maries 
63,Marion County,Missouri,1567,41,50,91,Marion 
64,Mercer County,Missouri,225,0,0,0,Mercer 
65,Miller County,Missouri,1102,11,114,125,Miller 
66,Mississippi County,Missouri,556,39,11,50,Mississippi 
67,Moniteau County,Missouri,843,274,55,329,Moniteau 
68,Monroe County,Missouri,408,79,28,107,Monroe 
69,Montgomery County,Missouri,507,47,20,67,Montgomery 
70,Morgan County,Missouri,961,272,263,535,Morgan 
71,New Madrid County,Missouri,679,60,28,88,New Madrid 
72,Newton County,Missouri,2895,97,62,159,Newton 
73,Nodaway County,Missouri,2912,22,51,73,Nodaway 
74,Oregon County,Missouri,448,70,16,86,Oregon 
75,Osage County,Missouri,736,37,50,87,Osage 
76,Ozark County,Missouri,461,8,0,8,Ozark 
77,Pemiscot County,Missouri,792,71,68,139,Pemiscot 
78,Perry County,Missouri,944,0,6,6,Perry 
79,Pettis County,Missouri,2370,26,15,41,Pettis 
80,Phelps County,Missouri,3481,38,53,91,Phelps 
81,Pike County,Missouri,815,28,102,130,Pike 
82,Platte County,Missouri,4842,228,88,316,Platte 
83,Polk County,Missouri,2034,82,65,147,Polk 
84,Pulaski County,Missouri,6691,11,27,38,Pulaski 
85,Putnam County,Missouri,261,10,0,10,Putnam 
86,Ralls County,Missouri,468,18,40,58,Ralls 
87,Randolph County,Missouri,1137,92,27,119,Randolph 
88,Ray County,Missouri,1070,72,21,93,Ray 
89,Reynolds County,Missouri,303,0,19,19,Reynolds 
90,Ripley County,Missouri,545,0,15,15,Ripley 
91,St. Charles County,Missouri,19828,291,89,380,St. Charles 
92,St. Clair County,Missouri,317,12,20,32,St. Clair 
93,Ste. Genevieve County,Missouri,802,93,36,129,Ste. Genevieve 
94,St. Francois County,Missouri,3191,124,56,180,St. Francois 
95,St. Louis County,Missouri,50035,877,693,1570,St. Louis 
96,Saline County,Missouri,1764,63,3,66,Saline 
97,Schuyler County,Missouri,266,31,51,82,Schuyler 
98,Scotland County,Missouri,289,106,58,164,Scotland 
99,Scott County,Missouri,1586,89,10,99,Scott 
100,Shannon County,Missouri,329,0,85,85,Shannon 
101,Shelby County,Missouri,296,25,8,33,Shelby 
102,Stoddard County,Missouri,1430,92,48,140,Stoddard 
103,Stone County,Missouri,1281,14,24,38,Stone 
104,Sullivan County,Missouri,273,5,6,11,Sullivan 
105,Taney County,Missouri,2902,74,45,119,Taney 
106,Texas County,Missouri,1239,92,56,148,Texas 
107,Vernon County,Missouri,1230,97,153,250,Vernon 
108,Warren County,Missouri,1704,4,152,156,Warren 
109,Washington County,Missouri,1344,33,33,66,Washington 
110,Wayne County,Missouri,620,14,0,14,Wayne 
111,Webster County,Missouri,2198,468,272,740,Webster 
112,Worth County,Missouri,66,0,2,2,Worth 
113,Wright County,Missouri,994,93,157,250,Wright 
114,St. Louis city,Missouri,12753,418,240,658,St. Louis city
0,Aitkin County,Minnesota,561,33,5,38,Aitkin 
1,Anoka County,Minnesota,17438,618,277,895,Anoka 
2,Becker County,Minnesota,1675,65,49,114,Becker 
3,Beltrami County,Minnesota,2820,100,98,198,Beltrami 
4,Benton County,Minnesota,1796,123,46,169,Benton 
5,Big Stone County,Minnesota,136,6,11,17,Big Stone 
6,Blue Earth County,Minnesota,5261,94,47,141,Blue Earth 
7,Brown County,Minnesota,1461,12,7,19,Brown 
8,Carlton County,Minnesota,1672,42,20,62,Carlton 
9,Carver County,Minnesota,6085,98,26,124,Carver 
10,Cass County,Minnesota,1219,62,38,100,Cass 
11,Chippewa County,Minnesota,544,2,2,4,Chippewa 
12,Chisago County,Minnesota,2887,89,28,117,Chisago 
13,Clay County,Minnesota,4597,46,61,107,Clay 
14,Clearwater County,Minnesota,439,20,9,29,Clearwater 
15,Cook County,Minnesota,156,20,0,20,Cook 
16,Cottonwood County,Minnesota,544,12,0,12,Cottonwood 
17,Crow Wing County,Minnesota,2906,58,184,242,Crow Wing 
18,Dakota County,Minnesota,20625,484,201,685,Dakota 
19,Dodge County,Minnesota,1130,5,2,7,Dodge 
20,Douglas County,Minnesota,1432,47,1,48,Douglas 
21,Faribault County,Minnesota,569,3,19,22,Faribault 
22,Fillmore County,Minnesota,961,104,53,157,Fillmore 
23,Freeborn County,Minnesota,1283,147,29,176,Freeborn 
24,Goodhue County,Minnesota,2241,36,0,36,Goodhue 
25,Grant County,Minnesota,206,0,1,1,Grant 
26,Hennepin County,Minnesota,57118,1326,734,2060,Hennepin 
27,Houston County,Minnesota,747,0,0,0,Houston 
28,Hubbard County,Minnesota,877,75,12,87,Hubbard 
29,Isanti County,Minnesota,1788,91,38,129,Isanti 
30,Itasca County,Minnesota,2283,74,0,74,Itasca 
31,Jackson County,Minnesota,409,1,10,11,Jackson 
32,Kanabec County,Minnesota,780,80,13,93,Kanabec 
33,Kandiyohi County,Minnesota,1905,50,91,141,Kandiyohi 
34,Kittson County,Minnesota,172,0,0,0,Kittson 
35,Koochiching County,Minnesota,611,2,3,5,Koochiching 
36,Lac qui Parle County,Minnesota,313,0,4,4,Lac qui Parle 
37,Lake County,Minnesota,344,6,47,53,Lake 
38,Lake of the Woods County,Minnesota,150,0,0,0,Lake of the Woods 
39,Le Sueur County,Minnesota,1363,64,26,90,Le Sueur 
40,Lincoln County,Minnesota,244,7,4,11,Lincoln 
41,Lyon County,Minnesota,1646,45,25,70,Lyon 
42,McLeod County,Minnesota,1738,0,31,31,McLeod 
43,Mahnomen County,Minnesota,298,30,23,53,Mahnomen 
44,Marshall County,Minnesota,432,2,2,4,Marshall 
45,Martin County,Minnesota,862,4,17,21,Martin 
46,Meeker County,Minnesota,1172,32,15,47,Meeker 
47,Mille Lacs County,Minnesota,1265,114,21,135,Mille Lacs 
48,Morrison County,Minnesota,1533,55,12,67,Morrison 
49,Mower County,Minnesota,1962,140,154,294,Mower 
50,Murray County,Minnesota,352,30,14,44,Murray 
51,Nicollet County,Minnesota,2187,36,10,46,Nicollet 
52,Nobles County,Minnesota,1079,77,4,81,Nobles 
53,Norman County,Minnesota,318,12,24,36,Norman 
54,Olmsted County,Minnesota,7051,341,37,378,Olmsted 
55,Otter Tail County,Minnesota,2607,66,104,170,Otter Tail 
56,Pennington County,Minnesota,666,4,0,4,Pennington 
57,Pine County,Minnesota,1364,65,31,96,Pine 
58,Pipestone County,Minnesota,412,3,68,71,Pipestone 
59,Polk County,Minnesota,1590,58,89,147,Polk 
60,Pope County,Minnesota,421,25,8,33,Pope 
61,Ramsey County,Minnesota,28293,925,730,1655,Ramsey 
62,Red Lake County,Minnesota,174,0,6,6,Red Lake 
63,Redwood County,Minnesota,780,5,15,20,Redwood 
64,Renville County,Minnesota,630,64,23,87,Renville 
65,Rice County,Minnesota,4704,31,62,93,Rice 
66,Rock County,Minnesota,509,46,17,63,Rock 
67,Roseau County,Minnesota,723,21,19,40,Roseau 
68,St. Louis County,Minnesota,11911,272,210,482,St. Louis 
69,Scott County,Minnesota,8031,294,119,413,Scott 
70,Sherburne County,Minnesota,5487,342,57,399,Sherburne 
71,Sibley County,Minnesota,685,45,0,45,Sibley 
72,Stearns County,Minnesota,10892,139,183,322,Stearns 
73,Steele County,Minnesota,1782,1,36,37,Steele 
74,Stevens County,Minnesota,865,22,76,98,Stevens 
75,Swift County,Minnesota,428,0,6,6,Swift 
76,Todd County,Minnesota,1057,120,73,193,Todd 
77,Traverse County,Minnesota,104,0,6,6,Traverse 
78,Wabasha County,Minnesota,967,84,22,106,Wabasha 
79,Wadena County,Minnesota,651,45,27,72,Wadena 
80,Waseca County,Minnesota,967,27,0,27,Waseca 
81,Washington County,Minnesota,13094,193,187,380,Washington 
82,Watonwan County,Minnesota,674,2,81,83,Watonwan 
83,Wilkin County,Minnesota,253,0,0,0,Wilkin 
84,Winona County,Minnesota,4117,19,44,63,Winona 
85,Wright County,Minnesota,7757,278,150,428,Wright 
86,Yellow Medicine County,Minnesota,439,5,0,5,Yellow Medicine 
0,Alachua County,Florida,19413,303,215,518,Alachua 
1,Baker County,Florida,1158,56,0,56,Baker 
2,Bay County,Florida,7836,228,42,270,Bay 
3,Bradford County,Florida,1171,22,68,90,Bradford 
4,Brevard County,Florida,25565,891,393,1284,Brevard 
5,Broward County,Florida,87888,2475,1259,3734,Broward 
6,Calhoun County,Florida,384,109,0,109,Calhoun 
7,Charlotte County,Florida,5352,271,15,286,Charlotte 
8,Citrus County,Florida,4817,34,202,236,Citrus 
9,Clay County,Florida,11430,535,249,784,Clay 
10,Collier County,Florida,14391,631,173,804,Collier 
11,Columbia County,Florida,3575,354,203,557,Columbia 
12,DeSoto County,Florida,2001,171,337,508,DeSoto 
13,Dixie County,Florida,672,32,0,32,Dixie 
14,Duval County,Florida,43686,1440,968,2408,Duval 
15,Escambia County,Florida,18242,1008,143,1151,Escambia 
16,Flagler County,Florida,4560,5,108,113,Flagler 
17,Franklin County,Florida,408,14,46,60,Franklin 
18,Gadsden County,Florida,1811,78,109,187,Gadsden 
19,Gilchrist County,Florida,1407,115,18,133,Gilchrist 
20,Glades County,Florida,503,151,0,151,Glades 
21,Gulf County,Florida,556,2,28,30,Gulf 
22,Hamilton County,Florida,594,53,20,73,Hamilton 
23,Hardee County,Florida,1361,192,6,198,Hardee 
24,Hendry County,Florida,2077,172,109,281,Hendry 
25,Hernando County,Florida,7660,578,335,913,Hernando 
26,Highlands County,Florida,3747,302,132,434,Highlands 
27,Hillsborough County,Florida,72963,2768,1725,4493,Hillsborough 
28,Holmes County,Florida,861,63,24,87,Holmes 
29,Indian River County,Florida,5897,282,99,381,Indian River 
30,Jackson County,Florida,2240,101,55,156,Jackson 
31,Jefferson County,Florida,594,0,0,0,Jefferson 
32,Lafayette County,Florida,440,0,0,0,Lafayette 
33,Lake County,Florida,14471,829,304,1133,Lake 
34,Lee County,Florida,30487,1407,1181,2588,Lee 
35,Leon County,Florida,22978,498,138,636,Leon 
36,Levy County,Florida,1528,59,57,116,Levy 
37,Liberty County,Florida,458,41,11,52,Liberty 
38,Madison County,Florida,927,125,3,128,Madison 
39,Manatee County,Florida,15525,1057,619,1676,Manatee 
40,Marion County,Florida,14547,486,612,1098,Marion 
41,Martin County,Florida,5896,224,190,414,Martin 
42,Miami-Dade County,Florida,126101,4757,1895,6652,Miami-Dade 
43,Monroe County,Florida,2588,48,0,48,Monroe 
44,Nassau County,Florida,3451,77,118,195,Nassau 
45,Okaloosa County,Florida,9007,452,322,774,Okaloosa 
46,Okeechobee County,Florida,2472,250,195,445,Okeechobee 
47,Orange County,Florida,71618,1594,778,2372,Orange 
48,Osceola County,Florida,20852,830,564,1394,Osceola 
49,Palm Beach County,Florida,64790,2602,1195,3797,Palm Beach 
50,Pasco County,Florida,23936,889,691,1580,Pasco 
51,Pinellas County,Florida,35126,1120,875,1995,Pinellas 
52,Polk County,Florida,34726,1561,769,2330,Polk 
53,Putnam County,Florida,2882,217,89,306,Putnam 
54,St. Johns County,Florida,12251,308,237,545,St. Johns 
55,St. Lucie County,Florida,14018,427,437,864,St. Lucie 
56,Santa Rosa County,Florida,8765,242,142,384,Santa Rosa 
57,Sarasota County,Florida,14700,606,136,742,Sarasota 
58,Seminole County,Florida,21799,645,204,849,Seminole 
59,Sumter County,Florida,2466,326,169,495,Sumter 
60,Suwannee County,Florida,2335,138,43,181,Suwannee 
61,Taylor County,Florida,1200,370,0,370,Taylor 
62,Union County,Florida,445,92,13,105,Union 
63,Volusia County,Florida,23832,960,731,1691,Volusia 
64,Wakulla County,Florida,1371,59,0,59,Wakulla 
65,Walton County,Florida,2890,0,62,62,Walton 
66,Washington County,Florida,952,106,23,129,Washington 
0,Adams County,Indiana,1887,610,312,922,Adams 
1,Allen County,Indiana,20649,1057,595,1652,Allen 
2,Bartholomew County,Indiana,4031,61,105,166,Bartholomew 
3,Benton County,Indiana,421,18,8,26,Benton 
4,Blackford County,Indiana,539,27,16,43,Blackford 
5,Boone County,Indiana,3332,112,17,129,Boone 
6,Brown County,Indiana,628,33,0,33,Brown 
7,Carroll County,Indiana,1011,82,8,90,Carroll 
8,Cass County,Indiana,2074,38,53,91,Cass 
9,Clark County,Indiana,5492,53,115,168,Clark 
10,Clay County,Indiana,1114,46,125,171,Clay 
11,Clinton County,Indiana,1685,23,17,40,Clinton 
12,Crawford County,Indiana,425,21,34,55,Crawford 
13,Daviess County,Indiana,1982,564,550,1114,Daviess 
14,Dearborn County,Indiana,2702,83,144,227,Dearborn 
15,Decatur County,Indiana,1287,26,8,34,Decatur 
16,DeKalb County,Indiana,2243,54,25,79,DeKalb 
17,Delaware County,Indiana,9290,206,96,302,Delaware 
18,Dubois County,Indiana,1901,40,51,91,Dubois 
19,Elkhart County,Indiana,11604,1082,1231,2313,Elkhart 
20,Fayette County,Indiana,1295,43,123,166,Fayette 
21,Floyd County,Indiana,4030,6,11,17,Floyd 
22,Fountain County,Indiana,692,38,50,88,Fountain 
23,Franklin County,Indiana,1216,80,15,95,Franklin 
24,Fulton County,Indiana,892,55,45,100,Fulton 
25,Gibson County,Indiana,1837,10,49,59,Gibson 
26,Grant County,Indiana,4229,200,66,266,Grant 
27,Greene County,Indiana,1619,99,0,99,Greene 
28,Hamilton County,Indiana,17328,552,428,980,Hamilton 
29,Hancock County,Indiana,3882,196,23,219,Hancock 
30,Harrison County,Indiana,1735,0,32,32,Harrison 
31,Hendricks County,Indiana,8868,217,77,294,Hendricks 
32,Henry County,Indiana,2225,75,62,137,Henry 
33,Howard County,Indiana,4121,107,75,182,Howard 
34,Huntington County,Indiana,2030,94,20,114,Huntington 
35,Jackson County,Indiana,2090,37,47,84,Jackson 
36,Jasper County,Indiana,2004,69,24,93,Jasper 
37,Jay County,Indiana,968,43,41,84,Jay 
38,Jefferson County,Indiana,1791,51,5,56,Jefferson 
39,Jennings County,Indiana,1373,46,0,46,Jennings 
40,Johnson County,Indiana,8355,177,215,392,Johnson 
41,Knox County,Indiana,2409,16,0,16,Knox 
42,Kosciusko County,Indiana,4449,463,361,824,Kosciusko 
43,LaGrange County,Indiana,2634,1222,1166,2388,LaGrange 
44,Lake County,Indiana,25944,472,443,915,Lake 
45,LaPorte County,Indiana,4782,287,129,416,LaPorte 
46,Lawrence County,Indiana,2406,266,86,352,Lawrence 
47,Madison County,Indiana,6751,309,136,445,Madison 
48,Marion County,Indiana,47098,1688,1531,3219,Marion 
49,Marshall County,Indiana,2465,179,305,484,Marshall 
50,Martin County,Indiana,514,28,23,51,Martin 
51,Miami County,Indiana,1689,25,25,50,Miami 
52,Monroe County,Indiana,14569,135,100,235,Monroe 
53,Montgomery County,Indiana,2080,96,25,121,Montgomery 
54,Morgan County,Indiana,3674,89,130,219,Morgan 
55,Newton County,Indiana,709,4,24,28,Newton 
56,Noble County,Indiana,2410,109,53,162,Noble 
57,Ohio County,Indiana,191,0,0,0,Ohio 
58,Orange County,Indiana,955,126,71,197,Orange 
59,Owen County,Indiana,937,0,38,38,Owen 
60,Parke County,Indiana,657,191,24,215,Parke 
61,Perry County,Indiana,692,74,4,78,Perry 
62,Pike County,Indiana,674,6,48,54,Pike 
63,Porter County,Indiana,9093,231,44,275,Porter 
64,Posey County,Indiana,1209,32,5,37,Posey 
65,Pulaski County,Indiana,634,11,0,11,Pulaski 
66,Putnam County,Indiana,2657,52,4,56,Putnam 
67,Randolph County,Indiana,1298,29,10,39,Randolph 
68,Ripley County,Indiana,1554,99,64,163,Ripley 
69,Rush County,Indiana,871,115,70,185,Rush 
70,St. Joseph County,Indiana,16262,370,423,793,St. Joseph 
71,Scott County,Indiana,1076,76,26,102,Scott 
72,Shelby County,Indiana,2090,164,93,257,Shelby 
73,Spencer County,Indiana,903,70,6,76,Spencer 
74,Starke County,Indiana,1121,6,104,110,Starke 
75,Steuben County,Indiana,1840,31,61,92,Steuben 
76,Sullivan County,Indiana,886,5,10,15,Sullivan 
77,Switzerland County,Indiana,573,30,0,30,Switzerland 
78,Tippecanoe County,Indiana,17393,190,96,286,Tippecanoe 
79,Tipton County,Indiana,704,50,33,83,Tipton 
80,Union County,Indiana,326,12,0,12,Union 
81,Vanderburgh County,Indiana,9168,294,141,435,Vanderburgh 
82,Vermillion County,Indiana,755,14,14,28,Vermillion 
83,Vigo County,Indiana,6941,168,221,389,Vigo 
84,Wabash County,Indiana,1774,117,1,118,Wabash 
85,Warren County,Indiana,269,2,0,2,Warren 
86,Warrick County,Indiana,3370,80,39,119,Warrick 
87,Washington County,Indiana,1327,218,46,264,Washington 
88,Wayne County,Indiana,3393,160,66,226,Wayne 
89,Wells County,Indiana,1419,65,39,104,Wells 
90,White County,Indiana,1173,98,0,98,White 
91,Whitley County,Indiana,1628,70,58,128,Whitley 
0,Aleutians East Borough,Alaska,112,2,0,2,Aleutians East Borough
1,Aleutians West Census Area,Alaska,251,20,0,20,Aleutians West Census Area
2,Anchorage Municipality,Alaska,14043,370,145,515,Anchorage Municipality
3,Bethel Census Area,Alaska,1195,67,24,91,Bethel Census Area
4,Bristol Bay Borough,Alaska,24,0,0,0,Bristol Bay Borough
5,Denali Borough,Alaska,149,10,0,10,Denali Borough
6,Dillingham Census Area,Alaska,297,8,17,25,Dillingham Census Area
7,Fairbanks North Star Borough,Alaska,4874,22,3,25,Fairbanks North Star Borough
8,Haines Borough,Alaska,65,0,0,0,Haines Borough
9,Hoonah-Angoon Census Area,Alaska,47,0,13,13,Hoonah-Angoon Census Area
10,Juneau City and Borough,Alaska,1404,0,78,78,Juneau City and Borough
11,Kenai Peninsula Borough,Alaska,2852,58,15,73,Kenai Peninsula Borough
12,Ketchikan Gateway Borough,Alaska,579,44,0,44,Ketchikan Gateway Borough
13,Kodiak Island Borough,Alaska,716,8,26,34,Kodiak Island Borough
14,Kusilvak Census Area,Alaska,570,47,27,74,Kusilvak Census Area
15,Lake and Peninsula Borough,Alaska,65,1,1,2,Lake and Peninsula Borough
16,Matanuska-Susitna Borough,Alaska,5669,334,125,459,Matanuska-Susitna Borough
17,Nome Census Area,Alaska,626,8,6,14,Nome Census Area
18,North Slope Borough,Alaska,492,13,6,19,North Slope Borough
19,Northwest Arctic Borough,Alaska,510,12,18,30,Northwest Arctic Borough
20,Petersburg Borough,Alaska,118,0,0,0,Petersburg Borough
21,Prince of Wales-Hyder Census Area,Alaska,283,6,6,12,Prince of Wales-Hyder Census Area
22,Sitka City and Borough,Alaska,410,37,32,69,Sitka City and Borough
23,Skagway Municipality,Alaska,58,0,0,0,Skagway Municipality
24,Southeast Fairbanks Census Area,Alaska,350,26,0,26,Southeast Fairbanks Census Area
25,Wrangell City and Borough,Alaska,119,8,0,8,Wrangell City and Borough
26,Yakutat City and Borough,Alaska,10,0,0,0,Yakutat City and Borough
27,Yukon-Koyukuk Census Area,Alaska,271,12,4,16,Yukon-Koyukuk Census Area
28,Chugach Census Area,Alaska,228,1,0,1,Chugach Census Area
29,Copper River Census Area,Alaska,86,0,8,8,Copper River Census Area
0,Kent County,Delaware,9436,684,528,1212,Kent 
1,New Castle County,Delaware,30809,694,629,1323,New Castle 
2,Sussex County,Delaware,8505,440,239,679,Sussex 
0,Adams County,Washington,1185,30,29,59,Adams 
1,Asotin County,Washington,1040,185,151,336,Asotin 
2,Benton County,Washington,10690,536,138,674,Benton 
3,Chelan County,Washington,3546,91,155,246,Chelan 
4,Clallam County,Washington,2817,85,123,208,Clallam 
5,Clark County,Washington,24238,806,665,1471,Clark 
6,Columbia County,Washington,109,0,0,0,Columbia 
7,Cowlitz County,Washington,5215,141,116,257,Cowlitz 
8,Douglas County,Washington,2196,99,26,125,Douglas 
9,Ferry County,Washington,273,10,6,16,Ferry 
10,Franklin County,Washington,6115,160,66,226,Franklin 
11,Garfield County,Washington,143,0,0,0,Garfield 
12,Grant County,Washington,5319,196,113,309,Grant 
13,Grays Harbor County,Washington,3158,211,74,285,Grays Harbor 
14,Island County,Washington,3239,160,50,210,Island 
15,Jefferson County,Washington,817,63,33,96,Jefferson 
16,King County,Washington,94462,2677,1695,4372,King 
17,Kitsap County,Washington,11603,399,296,695,Kitsap 
18,Kittitas County,Washington,4186,64,74,138,Kittitas 
19,Klickitat County,Washington,921,28,12,40,Klickitat 
20,Lewis County,Washington,4011,154,211,365,Lewis 
21,Lincoln County,Washington,507,2,0,2,Lincoln 
22,Mason County,Washington,2938,34,222,256,Mason 
23,Okanogan County,Washington,1851,19,132,151,Okanogan 
24,Pacific County,Washington,928,92,18,110,Pacific 
25,Pend Oreille County,Washington,634,30,2,32,Pend Oreille 
26,Pierce County,Washington,41918,1310,1045,2355,Pierce 
27,San Juan County,Washington,526,2,14,16,San Juan 
28,Skagit County,Washington,5974,308,279,587,Skagit 
29,Skamania County,Washington,524,6,57,63,Skamania 
30,Snohomish County,Washington,37003,1050,975,2025,Snohomish 
31,Spokane County,Washington,25563,952,582,1534,Spokane 
32,Stevens County,Washington,1934,114,40,154,Stevens 
33,Thurston County,Washington,13497,597,623,1220,Thurston 
34,Wahkiakum County,Washington,148,48,0,48,Wahkiakum 
35,Walla Walla County,Washington,3908,236,2,238,Walla Walla 
36,Whatcom County,Washington,12391,325,57,382,Whatcom 
37,Whitman County,Washington,7112,9,7,16,Whitman 
38,Yakima County,Washington,14530,925,605,1530,Yakima 
0,Adams County,North Dakota,155,0,0,0,Adams 
1,Barnes County,North Dakota,583,123,2,125,Barnes 
2,Benson County,North Dakota,384,26,10,36,Benson 
3,Billings County,North Dakota,56,0,0,0,Billings 
4,Bottineau County,North Dakota,354,4,0,4,Bottineau 
5,Bowman County,North Dakota,137,23,1,24,Bowman 
6,Burke County,North Dakota,57,0,0,0,Burke 
7,Burleigh County,North Dakota,5017,72,143,215,Burleigh 
8,Cass County,North Dakota,9522,81,50,131,Cass 
9,Cavalier County,North Dakota,91,0,0,0,Cavalier 
10,Dickey County,North Dakota,261,12,13,25,Dickey 
11,Divide County,North Dakota,84,0,4,4,Divide 
12,Dunn County,North Dakota,216,0,5,5,Dunn 
13,Eddy County,North Dakota,72,0,0,0,Eddy 
14,Emmons County,North Dakota,86,6,1,7,Emmons 
15,Foster County,North Dakota,99,0,0,0,Foster 
16,Golden Valley County,North Dakota,79,10,5,15,Golden Valley 
17,Grand Forks County,North Dakota,4928,269,9,278,Grand Forks 
18,Grant County,North Dakota,80,1,0,1,Grant 
19,Griggs County,North Dakota,58,0,0,0,Griggs 
20,Hettinger County,North Dakota,45,0,17,17,Hettinger 
21,Kidder County,North Dakota,150,0,0,0,Kidder 
22,LaMoure County,North Dakota,151,18,15,33,LaMoure 
23,Logan County,North Dakota,67,0,2,2,Logan 
24,McHenry County,North Dakota,219,0,8,8,McHenry 
25,McIntosh County,North Dakota,62,17,1,18,McIntosh 
26,McKenzie County,North Dakota,570,25,101,126,McKenzie 
27,McLean County,North Dakota,330,7,0,7,McLean 
28,Mercer County,North Dakota,369,6,2,8,Mercer 
29,Morton County,North Dakota,1294,216,19,235,Morton 
30,Mountrail County,North Dakota,666,35,66,101,Mountrail 
31,Nelson County,North Dakota,90,0,0,0,Nelson 
32,Oliver County,North Dakota,50,4,0,4,Oliver 
33,Pembina County,North Dakota,264,32,24,56,Pembina 
34,Pierce County,North Dakota,150,0,0,0,Pierce 
35,Ramsey County,North Dakota,621,26,44,70,Ramsey 
36,Ransom County,North Dakota,176,1,6,7,Ransom 
37,Renville County,North Dakota,99,1,0,1,Renville 
38,Richland County,North Dakota,1235,8,55,63,Richland 
39,Rolette County,North Dakota,929,153,31,184,Rolette 
40,Sargent County,North Dakota,114,0,0,0,Sargent 
41,Sheridan County,North Dakota,40,13,0,13,Sheridan 
42,Sioux County,North Dakota,333,38,61,99,Sioux 
43,Slope County,North Dakota,36,0,0,0,Slope 
44,Stark County,North Dakota,1456,0,10,10,Stark 
45,Steele County,North Dakota,34,4,0,4,Steele 
46,Stutsman County,North Dakota,1159,120,0,120,Stutsman 
47,Towner County,North Dakota,46,0,0,0,Towner 
48,Traill County,North Dakota,520,0,0,0,Traill 
49,Walsh County,North Dakota,477,2,2,4,Walsh 
50,Ward County,North Dakota,3544,60,47,107,Ward 
51,Wells County,North Dakota,73,0,0,0,Wells 
52,Williams County,North Dakota,1356,280,28,308,Williams 
0,Fairfield County,Connecticut,51661,1034,660,1694,Fairfield 
1,Hartford County,Connecticut,47146,690,911,1601,Hartford 
2,Litchfield County,Connecticut,8178,146,115,261,Litchfield 
3,Middlesex County,Connecticut,8138,127,120,247,Middlesex 
4,New Haven County,Connecticut,47714,650,341,991,New Haven 
5,New London County,Connecticut,13193,268,78,346,New London 
6,Tolland County,Connecticut,12499,142,280,422,Tolland 
7,Windham County,Connecticut,6724,321,146,467,Windham 
0,Atlantic County,New Jersey,13980,273,77,350,Atlantic 
1,Bergen County,New Jersey,46082,681,49,730,Bergen 
2,Burlington County,New Jersey,21080,492,131,623,Burlington 
3,Camden County,New Jersey,24351,690,392,1082,Camden 
4,Cape May County,New Jersey,3658,160,88,248,Cape May 
5,Cumberland County,New Jersey,7192,278,641,919,Cumberland 
6,Essex County,New Jersey,39651,1166,470,1636,Essex 
7,Gloucester County,New Jersey,14847,133,162,295,Gloucester 
8,Hudson County,New Jersey,25296,899,442,1341,Hudson 
9,Hunterdon County,New Jersey,7289,170,152,322,Hunterdon 
10,Mercer County,New Jersey,22273,393,199,592,Mercer 
11,Middlesex County,New Jersey,44100,489,257,746,Middlesex 
12,Monmouth County,New Jersey,32624,276,337,613,Monmouth 
13,Morris County,New Jersey,26023,308,225,533,Morris 
14,Ocean County,New Jersey,27100,430,350,780,Ocean 
15,Passaic County,New Jersey,27166,685,358,1043,Passaic 
16,Salem County,New Jersey,3045,67,70,137,Salem 
17,Somerset County,New Jersey,16798,246,227,473,Somerset 
18,Sussex County,New Jersey,7035,17,50,67,Sussex 
19,Union County,New Jersey,27135,502,329,831,Union 
20,Warren County,New Jersey,5471,126,22,148,Warren 
0,Alcona County,Michigan,311,29,12,41,Alcona 
1,Alger County,Michigan,400,5,31,36,Alger 
2,Allegan County,Michigan,5978,254,50,304,Allegan 
3,Alpena County,Michigan,1267,97,39,136,Alpena 
4,Antrim County,Michigan,1016,37,18,55,Antrim 
5,Arenac County,Michigan,606,24,15,39,Arenac 
6,Baraga County,Michigan,334,26,55,81,Baraga 
7,Barry County,Michigan,2970,204,79,283,Barry 
8,Bay County,Michigan,4881,174,128,302,Bay 
9,Benzie County,Michigan,678,18,0,18,Benzie 
10,Berrien County,Michigan,7007,198,202,400,Berrien 
11,Branch County,Michigan,2139,104,114,218,Branch 
12,Calhoun County,Michigan,7187,217,83,300,Calhoun 
13,Cass County,Michigan,2705,43,99,142,Cass 
14,Charlevoix County,Michigan,1099,20,52,72,Charlevoix 
15,Cheboygan County,Michigan,1086,72,29,101,Cheboygan 
16,Chippewa County,Michigan,1888,141,114,255,Chippewa 
17,Clare County,Michigan,1321,186,142,328,Clare 
18,Clinton County,Michigan,3966,65,74,139,Clinton 
19,Crawford County,Michigan,567,38,4,42,Crawford 
20,Delta County,Michigan,1689,42,23,65,Delta 
21,Dickinson County,Michigan,1125,8,0,8,Dickinson 
22,Eaton County,Michigan,5419,279,92,371,Eaton 
23,Emmet County,Michigan,1528,36,8,44,Emmet 
24,Genesee County,Michigan,20411,674,426,1100,Genesee 
25,Gladwin County,Michigan,1151,61,30,91,Gladwin 
26,Gogebic County,Michigan,579,1,31,32,Gogebic 
27,Grand Traverse County,Michigan,4298,159,28,187,Grand Traverse 
28,Gratiot County,Michigan,2411,61,39,100,Gratiot 
29,Hillsdale County,Michigan,2525,156,47,203,Hillsdale 
30,Houghton County,Michigan,3004,39,11,50,Houghton 
31,Huron County,Michigan,1273,47,49,96,Huron 
32,Ingham County,Michigan,23624,219,262,481,Ingham 
33,Ionia County,Michigan,3678,118,56,174,Ionia 
34,Iosco County,Michigan,899,67,10,77,Iosco 
35,Iron County,Michigan,404,16,12,28,Iron 
36,Isabella County,Michigan,7393,238,267,505,Isabella 
37,Jackson County,Michigan,8000,249,137,386,Jackson 
38,Kalamazoo County,Michigan,15111,576,322,898,Kalamazoo 
39,Kalkaska County,Michigan,776,49,46,95,Kalkaska 
40,Kent County,Michigan,33800,967,471,1438,Kent 
41,Keweenaw County,Michigan,67,1,1,2,Keweenaw 
42,Lake County,Michigan,413,2,2,4,Lake 
43,Lapeer County,Michigan,4319,245,88,333,Lapeer 
44,Leelanau County,Michigan,785,28,16,44,Leelanau 
45,Lenawee County,Michigan,5113,193,135,328,Lenawee 
46,Livingston County,Michigan,10000,305,157,462,Livingston 
47,Luce County,Michigan,278,13,0,13,Luce 
48,Mackinac County,Michigan,357,54,16,70,Mackinac 
49,Macomb County,Michigan,40709,1129,889,2018,Macomb 
50,Manistee County,Michigan,980,31,24,55,Manistee 
51,Marquette County,Michigan,3799,54,170,224,Marquette 
52,Mason County,Michigan,1254,43,57,100,Mason 
53,Mecosta County,Michigan,3702,203,141,344,Mecosta 
54,Menominee County,Michigan,1002,79,8,87,Menominee 
55,Midland County,Michigan,4011,86,75,161,Midland 
56,Missaukee County,Michigan,713,8,27,35,Missaukee 
57,Monroe County,Michigan,7334,276,159,435,Monroe 
58,Montcalm County,Michigan,2775,150,144,294,Montcalm 
59,Montmorency County,Michigan,323,17,0,17,Montmorency 
60,Muskegon County,Michigan,8925,289,353,642,Muskegon 
61,Newaygo County,Michigan,2361,184,118,302,Newaygo 
62,Oakland County,Michigan,60024,1340,1261,2601,Oakland 
63,Oceana County,Michigan,1367,42,31,73,Oceana 
64,Ogemaw County,Michigan,926,37,16,53,Ogemaw 
65,Ontonagon County,Michigan,213,12,26,38,Ontonagon 
66,Osceola County,Michigan,1213,114,97,211,Osceola 
67,Oscoda County,Michigan,315,63,60,123,Oscoda 
68,Otsego County,Michigan,1122,84,103,187,Otsego 
69,Ottawa County,Michigan,20693,600,560,1160,Ottawa 
70,Presque Isle County,Michigan,454,14,12,26,Presque Isle 
71,Roscommon County,Michigan,759,238,26,264,Roscommon 
72,Saginaw County,Michigan,10649,282,224,506,Saginaw 
73,St. Clair County,Michigan,8247,359,351,710,St. Clair 
74,St. Joseph County,Michigan,3205,285,221,506,St. Joseph 
75,Sanilac County,Michigan,2012,157,74,231,Sanilac 
76,Schoolcraft County,Michigan,259,20,6,26,Schoolcraft 
77,Shiawassee County,Michigan,3641,114,159,273,Shiawassee 
78,Tuscola County,Michigan,2465,103,83,186,Tuscola 
79,Van Buren County,Michigan,3785,60,129,189,Van Buren 
80,Washtenaw County,Michigan,28724,216,236,452,Washtenaw 
81,Wayne County,Michigan,87524,3461,1928,5389,Wayne 
82,Wexford County,Michigan,1379,19,65,84,Wexford 
0,Adair County,Iowa,269,0,12,12,Adair 
1,Adams County,Iowa,120,0,0,0,Adams 
2,Allamakee County,Iowa,568,83,45,128,Allamakee 
3,Appanoose County,Iowa,559,28,38,66,Appanoose 
4,Audubon County,Iowa,208,8,0,8,Audubon 
5,Benton County,Iowa,1286,18,30,48,Benton 
6,Black Hawk County,Iowa,7592,122,243,365,Black Hawk 
7,Boone County,Iowa,1367,7,14,21,Boone 
8,Bremer County,Iowa,1737,59,0,59,Bremer 
9,Buchanan County,Iowa,1082,139,127,266,Buchanan 
10,Buena Vista County,Iowa,1423,14,189,203,Buena Vista 
11,Butler County,Iowa,570,5,8,13,Butler 
12,Calhoun County,Iowa,286,1,4,5,Calhoun 
13,Carroll County,Iowa,905,3,0,3,Carroll 
14,Cass County,Iowa,672,34,56,90,Cass 
15,Cedar County,Iowa,964,8,0,8,Cedar 
16,Cerro Gordo County,Iowa,1985,35,253,288,Cerro Gordo 
17,Cherokee County,Iowa,404,4,1,5,Cherokee 
18,Chickasaw County,Iowa,546,2,102,104,Chickasaw 
19,Clarke County,Iowa,408,16,52,68,Clarke 
20,Clay County,Iowa,736,0,25,25,Clay 
21,Clayton County,Iowa,740,41,152,193,Clayton 
22,Clinton County,Iowa,2309,54,38,92,Clinton 
23,Crawford County,Iowa,1080,7,43,50,Crawford 
24,Dallas County,Iowa,4074,195,15,210,Dallas 
25,Davis County,Iowa,525,228,208,436,Davis 
26,Decatur County,Iowa,540,0,4,4,Decatur 
27,Delaware County,Iowa,725,6,0,6,Delaware 
28,Des Moines County,Iowa,2028,119,20,139,Des Moines 
29,Dickinson County,Iowa,771,8,89,97,Dickinson 
30,Dubuque County,Iowa,5862,163,31,194,Dubuque 
31,Emmet County,Iowa,849,16,0,16,Emmet 
32,Fayette County,Iowa,1055,33,62,95,Fayette 
33,Floyd County,Iowa,758,46,62,108,Floyd 
34,Franklin County,Iowa,374,0,0,0,Franklin 
35,Fremont County,Iowa,303,5,0,5,Fremont 
36,Greene County,Iowa,448,4,61,65,Greene 
37,Grundy County,Iowa,624,0,11,11,Grundy 
38,Guthrie County,Iowa,514,16,0,16,Guthrie 
39,Hamilton County,Iowa,613,5,14,19,Hamilton 
40,Hancock County,Iowa,440,8,10,18,Hancock 
41,Hardin County,Iowa,1016,4,20,24,Hardin 
42,Harrison County,Iowa,645,41,20,61,Harrison 
43,Henry County,Iowa,994,12,2,14,Henry 
44,Howard County,Iowa,359,8,0,8,Howard 
45,Humboldt County,Iowa,340,0,0,0,Humboldt 
46,Ida County,Iowa,322,0,19,19,Ida 
47,Iowa County,Iowa,720,0,58,58,Iowa 
48,Jackson County,Iowa,950,12,5,17,Jackson 
49,Jasper County,Iowa,1611,29,31,60,Jasper 
50,Jefferson County,Iowa,522,0,66,66,Jefferson 
51,Johnson County,Iowa,11223,212,333,545,Johnson 
52,Jones County,Iowa,938,84,71,155,Jones 
53,Keokuk County,Iowa,492,19,18,37,Keokuk 
54,Kossuth County,Iowa,674,14,54,68,Kossuth 
55,Lee County,Iowa,1456,99,0,99,Lee 
56,Linn County,Iowa,12038,327,119,446,Linn 
57,Louisa County,Iowa,495,37,25,62,Louisa 
58,Lucas County,Iowa,460,76,16,92,Lucas 
59,Lyon County,Iowa,591,20,4,24,Lyon 
60,Madison County,Iowa,729,20,0,20,Madison 
61,Mahaska County,Iowa,1306,31,92,123,Mahaska 
62,Marion County,Iowa,2040,4,24,28,Marion 
63,Marshall County,Iowa,2091,102,99,201,Marshall 
64,Mills County,Iowa,707,15,14,29,Mills 
65,Mitchell County,Iowa,500,132,27,159,Mitchell 
66,Monona County,Iowa,323,4,0,4,Monona 
67,Monroe County,Iowa,397,17,14,31,Monroe 
68,Montgomery County,Iowa,463,39,0,39,Montgomery 
69,Muscatine County,Iowa,2260,47,21,68,Muscatine 
70,O'Brien County,Iowa,709,3,5,8,O'Brien 
71,Osceola County,Iowa,244,0,2,2,Osceola 
72,Page County,Iowa,666,10,0,10,Page 
73,Palo Alto County,Iowa,436,2,0,2,Palo Alto 
74,Plymouth County,Iowa,1348,83,56,139,Plymouth 
75,Pocahontas County,Iowa,205,21,6,27,Pocahontas 
76,Polk County,Iowa,24760,1006,747,1753,Polk 
77,Pottawattamie County,Iowa,5152,197,94,291,Pottawattamie 
78,Poweshiek County,Iowa,1644,39,20,59,Poweshiek 
79,Ringgold County,Iowa,319,25,2,27,Ringgold 
80,Sac County,Iowa,403,0,10,10,Sac 
81,Scott County,Iowa,9125,130,151,281,Scott 
82,Shelby County,Iowa,560,43,49,92,Shelby 
83,Sioux County,Iowa,2530,29,1,30,Sioux 
84,Story County,Iowa,9775,90,32,122,Story 
85,Tama County,Iowa,911,39,60,99,Tama 
86,Taylor County,Iowa,288,34,0,34,Taylor 
87,Union County,Iowa,733,10,0,10,Union 
88,Van Buren County,Iowa,301,95,25,120,Van Buren 
89,Wapello County,Iowa,1770,93,35,128,Wapello 
90,Warren County,Iowa,3047,86,86,172,Warren 
91,Washington County,Iowa,1180,40,95,135,Washington 
92,Wayne County,Iowa,312,65,52,117,Wayne 
93,Webster County,Iowa,2392,144,53,197,Webster 
94,Winnebago County,Iowa,733,24,10,34,Winnebago 
95,Winneshiek County,Iowa,1648,0,12,12,Winneshiek 
96,Woodbury County,Iowa,5735,281,277,558,Woodbury 
97,Worth County,Iowa,344,3,1,4,Worth 
98,Wright County,Iowa,476,9,14,23,Wright 
0,Alamance County,North Carolina,10760,380,305,685,Alamance 
1,Alexander County,North Carolina,1724,54,7,61,Alexander 
2,Alleghany County,North Carolina,501,0,18,18,Alleghany 
3,Anson County,North Carolina,1182,52,0,52,Anson 
4,Ashe County,North Carolina,1171,85,37,122,Ashe 
5,Avery County,North Carolina,884,1,5,6,Avery 
6,Beaufort County,North Carolina,1996,158,43,201,Beaufort 
7,Bertie County,North Carolina,790,73,0,73,Bertie 
8,Bladen County,North Carolina,1592,140,77,217,Bladen 
9,Brunswick County,North Carolina,4615,205,103,308,Brunswick 
10,Buncombe County,North Carolina,11313,318,293,611,Buncombe 
11,Burke County,North Carolina,4477,616,98,714,Burke 
12,Cabarrus County,North Carolina,11918,165,527,692,Cabarrus 
13,Caldwell County,North Carolina,3804,124,138,262,Caldwell 
14,Camden County,North Carolina,472,0,0,0,Camden 
15,Carteret County,North Carolina,2917,47,58,105,Carteret 
16,Caswell County,North Carolina,1138,36,34,70,Caswell 
17,Catawba County,North Carolina,8571,256,197,453,Catawba 
18,Chatham County,North Carolina,3136,80,3,83,Chatham 
19,Cherokee County,North Carolina,924,53,44,97,Cherokee 
20,Chowan County,North Carolina,515,3,0,3,Chowan 
21,Clay County,North Carolina,384,31,156,187,Clay 
22,Cleveland County,North Carolina,5382,100,58,158,Cleveland 
23,Columbus County,North Carolina,2739,169,142,311,Columbus 
24,Craven County,North Carolina,4784,166,111,277,Craven 
25,Cumberland County,North Carolina,18621,649,377,1026,Cumberland 
26,Currituck County,North Carolina,1104,6,0,6,Currituck 
27,Dare County,North Carolina,1352,44,18,62,Dare 
28,Davidson County,North Carolina,8238,283,209,492,Davidson 
29,Davie County,North Carolina,2222,135,134,269,Davie 
30,Duplin County,North Carolina,3137,237,118,355,Duplin 
31,Durham County,North Carolina,16493,270,245,515,Durham 
32,Edgecombe County,North Carolina,2623,62,155,217,Edgecombe 
33,Forsyth County,North Carolina,22407,748,273,1021,Forsyth 
34,Franklin County,North Carolina,3283,160,0,160,Franklin 
35,Gaston County,North Carolina,11182,225,370,595,Gaston 
36,Gates County,North Carolina,519,0,0,0,Gates 
37,Graham County,North Carolina,480,21,0,21,Graham 
38,Granville County,North Carolina,3115,302,4,306,Granville 
39,Greene County,North Carolina,1092,73,0,73,Greene 
40,Guilford County,North Carolina,33497,629,482,1111,Guilford 
41,Halifax County,North Carolina,2319,70,69,139,Halifax 
42,Harnett County,North Carolina,7226,173,131,304,Harnett 
43,Haywood County,North Carolina,2523,84,30,114,Haywood 
44,Henderson County,North Carolina,5036,103,77,180,Henderson 
45,Hertford County,North Carolina,1565,29,69,98,Hertford 
46,Hoke County,North Carolina,2705,61,18,79,Hoke 
47,Hyde County,North Carolina,115,0,0,0,Hyde 
48,Iredell County,North Carolina,9154,437,227,664,Iredell 
49,Jackson County,North Carolina,4055,12,61,73,Jackson 
50,Johnston County,North Carolina,10730,263,124,387,Johnston 
51,Jones County,North Carolina,398,0,15,15,Jones 
52,Lee County,North Carolina,3129,66,4,70,Lee 
53,Lenoir County,North Carolina,2580,128,11,139,Lenoir 
54,Lincoln County,North Carolina,4224,146,36,182,Lincoln 
55,McDowell County,North Carolina,2011,11,0,11,McDowell 
56,Macon County,North Carolina,1393,54,16,70,Macon 
57,Madison County,North Carolina,1227,79,62,141,Madison 
58,Martin County,North Carolina,1065,64,42,106,Martin 
59,Mecklenburg County,North Carolina,54521,1931,1284,3215,Mecklenburg 
60,Mitchell County,North Carolina,646,0,20,20,Mitchell 
61,Montgomery County,North Carolina,1359,81,32,113,Montgomery 
62,Moore County,North Carolina,4205,109,50,159,Moore 
63,Nash County,North Carolina,4567,211,94,305,Nash 
64,New Hanover County,North Carolina,13005,469,118,587,New Hanover 
65,Northampton County,North Carolina,707,76,8,84,Northampton 
66,Onslow County,North Carolina,13038,300,250,550,Onslow 
67,Orange County,North Carolina,12336,137,104,241,Orange 
68,Pamlico County,North Carolina,469,33,0,33,Pamlico 
69,Pasquotank County,North Carolina,2127,180,26,206,Pasquotank 
70,Pender County,North Carolina,3312,95,73,168,Pender 
71,Perquimans County,North Carolina,618,5,30,35,Perquimans 
72,Person County,North Carolina,2336,43,45,88,Person 
73,Pitt County,North Carolina,12890,139,134,273,Pitt 
74,Polk County,North Carolina,755,0,8,8,Polk 
75,Randolph County,North Carolina,7527,294,335,629,Randolph 
76,Richmond County,North Carolina,2078,34,106,140,Richmond 
77,Robeson County,North Carolina,8198,277,226,503,Robeson 
78,Rockingham County,North Carolina,4360,146,45,191,Rockingham 
79,Rowan County,North Carolina,7556,305,56,361,Rowan 
80,Rutherford County,North Carolina,3143,92,68,160,Rutherford 
81,Sampson County,North Carolina,3037,222,32,254,Sampson 
82,Scotland County,North Carolina,1682,105,34,139,Scotland 
83,Stanly County,North Carolina,3141,95,303,398,Stanly 
84,Stokes County,North Carolina,2001,175,123,298,Stokes 
85,Surry County,North Carolina,3401,87,156,243,Surry 
86,Swain County,North Carolina,692,30,0,30,Swain 
87,Transylvania County,North Carolina,1326,43,50,93,Transylvania 
88,Tyrrell County,North Carolina,83,0,0,0,Tyrrell 
89,Union County,North Carolina,16090,1006,112,1118,Union 
90,Vance County,North Carolina,2401,57,117,174,Vance 
91,Wake County,North Carolina,60098,1593,747,2340,Wake 
92,Warren County,North Carolina,1354,142,90,232,Warren 
93,Washington County,North Carolina,786,50,40,90,Washington 
94,Watauga County,North Carolina,6907,27,7,34,Watauga 
95,Wayne County,North Carolina,6460,160,73,233,Wayne 
96,Wilkes County,North Carolina,2989,170,91,261,Wilkes 
97,Wilson County,North Carolina,4297,153,403,556,Wilson 
98,Yadkin County,North Carolina,1784,81,68,149,Yadkin 
99,Yancey County,North Carolina,730,44,0,44,Yancey 
0,Addison County,Vermont,2612,24,4,28,Addison 
1,Bennington County,Vermont,1679,59,58,117,Bennington 
2,Caledonia County,Vermont,1644,26,22,48,Caledonia 
3,Chittenden County,Vermont,11863,199,224,423,Chittenden 
4,Essex County,Vermont,214,0,0,0,Essex 
5,Franklin County,Vermont,2555,241,168,409,Franklin 
6,Grand Isle County,Vermont,310,12,0,12,Grand Isle 
7,Lamoille County,Vermont,1317,17,79,96,Lamoille 
8,Orange County,Vermont,1442,53,128,181,Orange 
9,Orleans County,Vermont,1169,14,34,48,Orleans 
10,Rutland County,Vermont,3152,25,31,56,Rutland 
11,Washington County,Vermont,3185,74,109,183,Washington 
12,Windham County,Vermont,1974,99,54,153,Windham 
13,Windsor County,Vermont,2168,16,58,74,Windsor 
0,Ada County,Idaho,24994,499,278,777,Ada 
1,Adams County,Idaho,114,12,10,22,Adams 
2,Bannock County,Idaho,5414,361,74,435,Bannock 
3,Bear Lake County,Idaho,345,12,6,18,Bear Lake 
4,Benewah County,Idaho,507,88,8,96,Benewah 
5,Bingham County,Idaho,2933,162,126,288,Bingham 
6,Blaine County,Idaho,1210,2,4,6,Blaine 
7,Boise County,Idaho,440,11,0,11,Boise 
8,Bonner County,Idaho,1907,133,20,153,Bonner 
9,Bonneville County,Idaho,6759,384,499,883,Bonneville 
10,Boundary County,Idaho,614,11,44,55,Boundary 
11,Butte County,Idaho,84,75,0,75,Butte 
12,Camas County,Idaho,56,0,0,0,Camas 
13,Canyon County,Idaho,13222,451,434,885,Canyon 
14,Caribou County,Idaho,433,0,3,3,Caribou 
15,Cassia County,Idaho,1512,52,16,68,Cassia 
16,Clark County,Idaho,96,0,0,0,Clark 
17,Clearwater County,Idaho,316,3,0,3,Clearwater 
18,Custer County,Idaho,222,0,0,0,Custer 
19,Elmore County,Idaho,1243,110,60,170,Elmore 
20,Franklin County,Idaho,1013,0,0,0,Franklin 
21,Fremont County,Idaho,837,27,5,32,Fremont 
22,Gem County,Idaho,747,0,0,0,Gem 
23,Gooding County,Idaho,826,267,42,309,Gooding 
24,Idaho County,Idaho,674,61,18,79,Idaho 
25,Jefferson County,Idaho,2002,8,0,8,Jefferson 
26,Jerome County,Idaho,1346,2,32,34,Jerome 
27,Kootenai County,Idaho,7292,771,194,965,Kootenai 
28,Latah County,Idaho,3589,0,8,8,Latah 
29,Lemhi County,Idaho,303,26,0,26,Lemhi 
30,Lewis County,Idaho,193,11,36,47,Lewis 
31,Lincoln County,Idaho,268,7,0,7,Lincoln 
32,Madison County,Idaho,4087,0,0,0,Madison 
33,Minidoka County,Idaho,1148,22,0,22,Minidoka 
34,Nez Perce County,Idaho,1823,163,20,183,Nez Perce 
35,Oneida County,Idaho,220,32,1,33,Oneida 
36,Owyhee County,Idaho,851,92,29,121,Owyhee 
37,Payette County,Idaho,1112,48,21,69,Payette 
38,Power County,Idaho,362,0,0,0,Power 
39,Shoshone County,Idaho,626,30,92,122,Shoshone 
40,Teton County,Idaho,634,94,72,166,Teton 
41,Twin Falls County,Idaho,4499,204,244,448,Twin Falls 
42,Valley County,Idaho,347,0,0,0,Valley 
43,Washington County,Idaho,438,38,10,48,Washington 
0,Appling County,Georgia,1047,9,5,14,Appling 
1,Atkinson County,Georgia,679,0,56,56,Atkinson 
2,Bacon County,Georgia,479,79,43,122,Bacon 
3,Baker County,Georgia,106,3,0,3,Baker 
4,Baldwin County,Georgia,4211,149,44,193,Baldwin 
5,Banks County,Georgia,966,22,0,22,Banks 
6,Barrow County,Georgia,4120,260,147,407,Barrow 
7,Bartow County,Georgia,5658,372,202,574,Bartow 
8,Ben Hill County,Georgia,1129,117,0,117,Ben Hill 
9,Berrien County,Georgia,900,77,17,94,Berrien 
10,Bibb County,Georgia,8913,307,309,616,Bibb 
11,Bleckley County,Georgia,1186,0,11,11,Bleckley 
12,Brantley County,Georgia,850,120,166,286,Brantley 
13,Brooks County,Georgia,826,34,0,34,Brooks 
14,Bryan County,Georgia,2281,103,46,149,Bryan 
15,Bulloch County,Georgia,8386,195,35,230,Bulloch 
16,Burke County,Georgia,1267,129,77,206,Burke 
17,Butts County,Georgia,1011,36,124,160,Butts 
18,Calhoun County,Georgia,330,16,4,20,Calhoun 
19,Camden County,Georgia,2875,132,25,157,Camden 
20,Candler County,Georgia,740,32,0,32,Candler 
21,Carroll County,Georgia,8268,114,107,221,Carroll 
22,Catoosa County,Georgia,3323,120,38,158,Catoosa 
23,Charlton County,Georgia,726,0,10,10,Charlton 
24,Chatham County,Georgia,15367,800,252,1052,Chatham 
25,Chattahoochee County,Georgia,1102,0,0,0,Chattahoochee 
26,Chattooga County,Georgia,1200,90,18,108,Chattooga 
27,Cherokee County,Georgia,13309,556,157,713,Cherokee 
28,Clarke County,Georgia,12638,149,32,181,Clarke 
29,Clay County,Georgia,246,0,0,0,Clay 
30,Clayton County,Georgia,16718,916,538,1454,Clayton 
31,Clinch County,Georgia,473,12,16,28,Clinch 
32,Cobb County,Georgia,40167,1445,681,2126,Cobb 
33,Coffee County,Georgia,2485,47,5,52,Coffee 
34,Colquitt County,Georgia,2282,74,25,99,Colquitt 
35,Columbia County,Georgia,7842,135,39,174,Columbia 
36,Cook County,Georgia,1099,10,163,173,Cook 
37,Coweta County,Georgia,7695,590,324,914,Coweta 
38,Crawford County,Georgia,636,7,0,7,Crawford 
39,Crisp County,Georgia,1500,7,32,39,Crisp 
40,Dade County,Georgia,1341,52,17,69,Dade 
41,Dawson County,Georgia,1177,55,0,55,Dawson 
42,Decatur County,Georgia,1295,22,59,81,Decatur 
43,DeKalb County,Georgia,34513,1709,790,2499,DeKalb 
44,Dodge County,Georgia,830,76,33,109,Dodge 
45,Dooly County,Georgia,900,26,57,83,Dooly 
46,Dougherty County,Georgia,5392,260,88,348,Dougherty 
47,Douglas County,Georgia,8742,372,371,743,Douglas 
48,Early County,Georgia,561,4,154,158,Early 
49,Echols County,Georgia,363,24,0,24,Echols 
50,Effingham County,Georgia,3007,22,22,44,Effingham 
51,Elbert County,Georgia,898,0,32,32,Elbert 
52,Emanuel County,Georgia,1176,206,74,280,Emanuel 
53,Evans County,Georgia,423,11,0,11,Evans 
54,Fannin County,Georgia,903,70,104,174,Fannin 
55,Fayette County,Georgia,7046,90,77,167,Fayette 
56,Floyd County,Georgia,5651,202,238,440,Floyd 
57,Forsyth County,Georgia,13332,280,220,500,Forsyth 
58,Franklin County,Georgia,1301,10,8,18,Franklin 
59,Fulton County,Georgia,56909,1477,623,2100,Fulton 
60,Gilmer County,Georgia,1042,10,20,30,Gilmer 
61,Glascock County,Georgia,257,10,0,10,Glascock 
62,Glynn County,Georgia,3903,272,291,563,Glynn 
63,Gordon County,Georgia,3019,217,215,432,Gordon 
64,Grady County,Georgia,1251,38,7,45,Grady 
65,Greene County,Georgia,875,29,25,54,Greene 
66,Gwinnett County,Georgia,53887,1250,1552,2802,Gwinnett 
67,Habersham County,Georgia,2647,72,129,201,Habersham 
68,Hall County,Georgia,11046,721,385,1106,Hall 
69,Hancock County,Georgia,144,44,10,54,Hancock 
70,Haralson County,Georgia,1488,52,52,104,Haralson 
71,Harris County,Georgia,1758,29,3,32,Harris 
72,Hart County,Georgia,859,0,28,28,Hart 
73,Heard County,Georgia,511,146,0,146,Heard 
74,Henry County,Georgia,15028,499,284,783,Henry 
75,Houston County,Georgia,8196,261,48,309,Houston 
76,Irwin County,Georgia,806,0,0,0,Irwin 
77,Jackson County,Georgia,3509,190,13,203,Jackson 
78,Jasper County,Georgia,576,20,16,36,Jasper 
79,Jeff Davis County,Georgia,843,3,0,3,Jeff Davis 
80,Jefferson County,Georgia,886,10,16,26,Jefferson 
81,Jenkins County,Georgia,293,0,0,0,Jenkins 
82,Johnson County,Georgia,353,26,24,50,Johnson 
83,Jones County,Georgia,1470,55,40,95,Jones 
84,Lamar County,Georgia,1740,80,0,80,Lamar 
85,Lanier County,Georgia,554,17,0,17,Lanier 
86,Laurens County,Georgia,2379,101,98,199,Laurens 
87,Lee County,Georgia,1827,41,60,101,Lee 
88,Liberty County,Georgia,3019,35,27,62,Liberty 
89,Lincoln County,Georgia,472,8,0,8,Lincoln 
90,Long County,Georgia,1515,280,0,280,Long 
91,Lowndes County,Georgia,7645,349,61,410,Lowndes 
92,Lumpkin County,Georgia,2632,21,0,21,Lumpkin 
93,McDuffie County,Georgia,1001,81,0,81,McDuffie 
94,McIntosh County,Georgia,354,28,12,40,McIntosh 
95,Macon County,Georgia,626,36,241,277,Macon 
96,Madison County,Georgia,1264,6,27,33,Madison 
97,Marion County,Georgia,572,0,45,45,Marion 
98,Meriwether County,Georgia,1215,99,8,107,Meriwether 
99,Miller County,Georgia,271,36,6,42,Miller 
100,Mitchell County,Georgia,708,39,0,39,Mitchell 
101,Monroe County,Georgia,1499,109,0,109,Monroe 
102,Montgomery County,Georgia,713,0,35,35,Montgomery 
103,Morgan County,Georgia,1029,23,0,23,Morgan 
104,Murray County,Georgia,2100,24,129,153,Murray 
105,Muscogee County,Georgia,10284,330,258,588,Muscogee 
106,Newton County,Georgia,6712,191,183,374,Newton 
107,Oconee County,Georgia,2572,0,17,17,Oconee 
108,Oglethorpe County,Georgia,845,253,21,274,Oglethorpe 
109,Paulding County,Georgia,9498,392,303,695,Paulding 
110,Peach County,Georgia,2200,10,16,26,Peach 
111,Pickens County,Georgia,1631,292,0,292,Pickens 
112,Pierce County,Georgia,1086,70,316,386,Pierce 
113,Pike County,Georgia,1293,20,8,28,Pike 
114,Polk County,Georgia,2362,146,255,401,Polk 
115,Pulaski County,Georgia,479,0,0,0,Pulaski 
116,Putnam County,Georgia,1359,79,21,100,Putnam 
117,Quitman County,Georgia,39,0,0,0,Quitman 
118,Rabun County,Georgia,606,39,15,54,Rabun 
119,Randolph County,Georgia,331,0,5,5,Randolph 
120,Richmond County,Georgia,11141,387,130,517,Richmond 
121,Rockdale County,Georgia,5012,31,172,203,Rockdale 
122,Schley County,Georgia,322,19,0,19,Schley 
123,Screven County,Georgia,679,27,53,80,Screven 
124,Seminole County,Georgia,304,52,0,52,Seminole 
125,Spalding County,Georgia,2563,137,77,214,Spalding 
126,Stephens County,Georgia,1487,19,38,57,Stephens 
127,Stewart County,Georgia,327,43,0,43,Stewart 
128,Sumter County,Georgia,1779,47,59,106,Sumter 
129,Talbot County,Georgia,323,8,4,12,Talbot 
130,Taliaferro County,Georgia,46,0,0,0,Taliaferro 
131,Tattnall County,Georgia,952,34,7,41,Tattnall 
132,Taylor County,Georgia,328,48,11,59,Taylor 
133,Telfair County,Georgia,689,128,0,128,Telfair 
134,Terrell County,Georgia,419,8,0,8,Terrell 
135,Thomas County,Georgia,1865,83,9,92,Thomas 
136,Tift County,Georgia,2807,14,8,22,Tift 
137,Toombs County,Georgia,1387,76,14,90,Toombs 
138,Towns County,Georgia,805,42,38,80,Towns 
139,Treutlen County,Georgia,429,6,0,6,Treutlen 
140,Troup County,Georgia,3372,353,51,404,Troup 
141,Turner County,Georgia,361,14,20,34,Turner 
142,Twiggs County,Georgia,327,0,0,0,Twiggs 
143,Union County,Georgia,924,62,0,62,Union 
144,Upson County,Georgia,1382,14,0,14,Upson 
145,Walker County,Georgia,3352,55,69,124,Walker 
146,Walton County,Georgia,5336,193,133,326,Walton 
147,Ware County,Georgia,1929,103,48,151,Ware 
148,Warren County,Georgia,135,0,7,7,Warren 
149,Washington County,Georgia,1090,10,51,61,Washington 
150,Wayne County,Georgia,1705,163,128,291,Wayne 
151,Webster County,Georgia,122,30,0,30,Webster 
152,Wheeler County,Georgia,1207,284,0,284,Wheeler 
153,White County,Georgia,1792,30,0,30,White 
154,Whitfield County,Georgia,6263,164,205,369,Whitfield 
155,Wilcox County,Georgia,417,152,3,155,Wilcox 
156,Wilkes County,Georgia,472,6,11,17,Wilkes 
157,Wilkinson County,Georgia,528,5,6,11,Wilkinson 
158,Worth County,Georgia,925,23,76,99,Worth 
0,Adams County,Nebraska,2189,12,62,74,Adams 
1,Antelope County,Nebraska,295,10,62,72,Antelope 
2,Arthur County,Nebraska,20,0,0,0,Arthur 
3,Banner County,Nebraska,32,0,0,0,Banner 
4,Blaine County,Nebraska,2,0,0,0,Blaine 
5,Boone County,Nebraska,243,8,0,8,Boone 
6,Box Butte County,Nebraska,495,5,0,5,Box Butte 
7,Boyd County,Nebraska,44,0,0,0,Boyd 
8,Brown County,Nebraska,121,0,6,6,Brown 
9,Buffalo County,Nebraska,3877,260,43,303,Buffalo 
10,Burt County,Nebraska,260,5,7,12,Burt 
11,Butler County,Nebraska,454,17,2,19,Butler 
12,Cass County,Nebraska,1169,52,15,67,Cass 
13,Cedar County,Nebraska,433,10,1,11,Cedar 
14,Chase County,Nebraska,154,0,0,0,Chase 
15,Cherry County,Nebraska,309,0,0,0,Cherry 
16,Cheyenne County,Nebraska,467,0,0,0,Cheyenne 
17,Clay County,Nebraska,291,0,7,7,Clay 
18,Colfax County,Nebraska,486,120,0,120,Colfax 
19,Cuming County,Nebraska,339,42,0,42,Cuming 
20,Custer County,Nebraska,454,82,0,82,Custer 
21,Dakota County,Nebraska,787,89,16,105,Dakota 
22,Dawes County,Nebraska,1083,0,0,0,Dawes 
23,Dawson County,Nebraska,1217,19,47,66,Dawson 
24,Deuel County,Nebraska,39,0,0,0,Deuel 
25,Dixon County,Nebraska,234,0,0,0,Dixon 
26,Dodge County,Nebraska,1849,101,16,117,Dodge 
27,Douglas County,Nebraska,29417,788,642,1430,Douglas 
28,Dundy County,Nebraska,74,0,0,0,Dundy 
29,Fillmore County,Nebraska,219,5,5,10,Fillmore 
30,Franklin County,Nebraska,104,0,0,0,Franklin 
31,Frontier County,Nebraska,177,0,0,0,Frontier 
32,Furnas County,Nebraska,240,14,8,22,Furnas 
33,Gage County,Nebraska,952,1,0,1,Gage 
34,Garden County,Nebraska,78,3,6,9,Garden 
35,Garfield County,Nebraska,63,15,0,15,Garfield 
36,Gosper County,Nebraska,80,0,0,0,Gosper 
37,Grant County,Nebraska,56,0,0,0,Grant 
38,Greeley County,Nebraska,102,8,9,17,Greeley 
39,Hall County,Nebraska,3236,133,26,159,Hall 
40,Hamilton County,Nebraska,478,4,55,59,Hamilton 
41,Harlan County,Nebraska,122,6,10,16,Harlan 
42,Hayes County,Nebraska,22,4,2,6,Hayes 
43,Hitchcock County,Nebraska,132,0,0,0,Hitchcock 
44,Holt County,Nebraska,291,8,13,21,Holt 
45,Hooker County,Nebraska,36,0,0,0,Hooker 
46,Howard County,Nebraska,193,47,0,47,Howard 
47,Jefferson County,Nebraska,224,0,0,0,Jefferson 
48,Johnson County,Nebraska,206,0,0,0,Johnson 
49,Kearney County,Nebraska,265,1,0,1,Kearney 
50,Keith County,Nebraska,303,14,20,34,Keith 
51,Keya Paha County,Nebraska,53,0,3,3,Keya Paha 
52,Kimball County,Nebraska,201,27,65,92,Kimball 
53,Knox County,Nebraska,396,11,4,15,Knox 
54,Lancaster County,Nebraska,19674,207,251,458,Lancaster 
55,Lincoln County,Nebraska,1689,18,95,113,Lincoln 
56,Logan County,Nebraska,79,0,0,0,Logan 
57,Loup County,Nebraska,19,0,0,0,Loup 
58,McPherson County,Nebraska,19,0,0,0,McPherson 
59,Madison County,Nebraska,1843,60,12,72,Madison 
60,Merrick County,Nebraska,410,7,18,25,Merrick 
61,Morrill County,Nebraska,288,34,0,34,Morrill 
62,Nance County,Nebraska,144,3,0,3,Nance 
63,Nemaha County,Nebraska,567,1,20,21,Nemaha 
64,Nuckolls County,Nebraska,205,22,15,37,Nuckolls 
65,Otoe County,Nebraska,626,5,6,11,Otoe 
66,Pawnee County,Nebraska,139,38,17,55,Pawnee 
67,Perkins County,Nebraska,115,17,7,24,Perkins 
68,Phelps County,Nebraska,368,0,0,0,Phelps 
69,Pierce County,Nebraska,350,0,9,9,Pierce 
70,Platte County,Nebraska,1852,0,79,79,Platte 
71,Polk County,Nebraska,301,0,8,8,Polk 
72,Red Willow County,Nebraska,877,0,0,0,Red Willow 
73,Richardson County,Nebraska,405,72,0,72,Richardson 
74,Rock County,Nebraska,101,0,6,6,Rock 
75,Saline County,Nebraska,972,2,0,2,Saline 
76,Sarpy County,Nebraska,10219,270,166,436,Sarpy 
77,Saunders County,Nebraska,1139,17,0,17,Saunders 
78,Scotts Bluff County,Nebraska,1765,18,0,18,Scotts Bluff 
79,Seward County,Nebraska,1338,20,1,21,Seward 
80,Sheridan County,Nebraska,184,0,0,0,Sheridan 
81,Sherman County,Nebraska,116,0,8,8,Sherman 
82,Sioux County,Nebraska,12,0,0,0,Sioux 
83,Stanton County,Nebraska,287,20,0,20,Stanton 
84,Thayer County,Nebraska,173,8,0,8,Thayer 
85,Thomas County,Nebraska,7,0,0,0,Thomas 
86,Thurston County,Nebraska,498,11,4,15,Thurston 
87,Valley County,Nebraska,205,1,46,47,Valley 
88,Washington County,Nebraska,1101,24,0,24,Washington 
89,Wayne County,Nebraska,1402,0,0,0,Wayne 
90,Webster County,Nebraska,132,0,0,0,Webster 
91,Wheeler County,Nebraska,14,0,0,0,Wheeler 
92,York County,Nebraska,656,3,6,9,York 
0,Adams County,Mississippi,1617,167,199,366,Adams 
1,Alcorn County,Mississippi,1950,43,54,97,Alcorn 
2,Amite County,Mississippi,459,33,14,47,Amite 
3,Attala County,Mississippi,1084,48,26,74,Attala 
4,Benton County,Mississippi,558,129,0,129,Benton 
5,Bolivar County,Mississippi,1936,56,0,56,Bolivar 
6,Calhoun County,Mississippi,638,14,36,50,Calhoun 
7,Carroll County,Mississippi,561,47,76,123,Carroll 
8,Chickasaw County,Mississippi,975,22,115,137,Chickasaw 
9,Choctaw County,Mississippi,483,0,0,0,Choctaw 
10,Claiborne County,Mississippi,1037,0,0,0,Claiborne 
11,Clarke County,Mississippi,895,38,0,38,Clarke 
12,Clay County,Mississippi,1170,48,62,110,Clay 
13,Coahoma County,Mississippi,1491,93,19,112,Coahoma 
14,Copiah County,Mississippi,1935,126,56,182,Copiah 
15,Covington County,Mississippi,987,104,61,165,Covington 
16,DeSoto County,Mississippi,10680,368,271,639,DeSoto 
17,Forrest County,Mississippi,4153,39,1,40,Forrest 
18,Franklin County,Mississippi,264,5,0,5,Franklin 
19,George County,Mississippi,1247,60,25,85,George 
20,Greene County,Mississippi,651,25,0,25,Greene 
21,Grenada County,Mississippi,1053,79,27,106,Grenada 
22,Hancock County,Mississippi,2061,71,175,246,Hancock 
23,Harrison County,Mississippi,10740,489,267,756,Harrison 
24,Hinds County,Mississippi,14233,819,290,1109,Hinds 
25,Holmes County,Mississippi,1205,22,0,22,Holmes 
26,Humphreys County,Mississippi,418,25,5,30,Humphreys 
27,Issaquena County,Mississippi,8,0,0,0,Issaquena 
28,Itawamba County,Mississippi,1570,56,68,124,Itawamba 
29,Jackson County,Mississippi,7721,306,26,332,Jackson 
30,Jasper County,Mississippi,808,45,0,45,Jasper 
31,Jefferson County,Mississippi,397,0,0,0,Jefferson 
32,Jefferson Davis County,Mississippi,511,54,0,54,Jefferson Davis 
33,Jones County,Mississippi,4233,217,182,399,Jones 
34,Kemper County,Mississippi,668,0,0,0,Kemper 
35,Lafayette County,Mississippi,5473,205,146,351,Lafayette 
36,Lamar County,Mississippi,3215,27,350,377,Lamar 
37,Lauderdale County,Mississippi,3689,169,99,268,Lauderdale 
38,Lawrence County,Mississippi,719,12,28,40,Lawrence 
39,Leake County,Mississippi,1373,6,28,34,Leake 
40,Lee County,Mississippi,4540,329,114,443,Lee 
41,Leflore County,Mississippi,1913,111,159,270,Leflore 
42,Lincoln County,Mississippi,2111,44,31,75,Lincoln 
43,Lowndes County,Mississippi,3041,75,0,75,Lowndes 
44,Madison County,Mississippi,5801,158,11,169,Madison 
45,Marion County,Mississippi,1235,82,0,82,Marion 
46,Marshall County,Mississippi,1913,59,8,67,Marshall 
47,Monroe County,Mississippi,1327,52,26,78,Monroe 
48,Montgomery County,Mississippi,404,0,0,0,Montgomery 
49,Neshoba County,Mississippi,1761,83,41,124,Neshoba 
50,Newton County,Mississippi,1382,120,1,121,Newton 
51,Noxubee County,Mississippi,709,135,132,267,Noxubee 
52,Oktibbeha County,Mississippi,5358,38,51,89,Oktibbeha 
53,Panola County,Mississippi,1500,31,85,116,Panola 
54,Pearl River County,Mississippi,2980,187,184,371,Pearl River 
55,Perry County,Mississippi,640,43,57,100,Perry 
56,Pike County,Mississippi,2359,139,28,167,Pike 
57,Pontotoc County,Mississippi,1451,22,148,170,Pontotoc 
58,Prentiss County,Mississippi,1267,1,29,30,Prentiss 
59,Quitman County,Mississippi,367,10,0,10,Quitman 
60,Rankin County,Mississippi,7966,342,72,414,Rankin 
61,Scott County,Mississippi,1571,206,36,242,Scott 
62,Sharkey County,Mississippi,241,0,0,0,Sharkey 
63,Simpson County,Mississippi,1246,0,37,37,Simpson 
64,Smith County,Mississippi,834,19,0,19,Smith 
65,Stone County,Mississippi,1383,21,44,65,Stone 
66,Sunflower County,Mississippi,1295,23,93,116,Sunflower 
67,Tallahatchie County,Mississippi,602,7,0,7,Tallahatchie 
68,Tate County,Mississippi,2438,17,14,31,Tate 
69,Tippah County,Mississippi,1241,18,24,42,Tippah 
70,Tishomingo County,Mississippi,875,0,36,36,Tishomingo 
71,Tunica County,Mississippi,497,29,14,43,Tunica 
72,Union County,Mississippi,1249,167,4,171,Union 
73,Walthall County,Mississippi,868,31,0,31,Walthall 
74,Warren County,Mississippi,2429,50,149,199,Warren 
75,Washington County,Mississippi,2454,93,48,141,Washington 
76,Wayne County,Mississippi,1130,24,0,24,Wayne 
77,Webster County,Mississippi,625,40,81,121,Webster 
78,Wilkinson County,Mississippi,278,10,8,18,Wilkinson 
79,Winston County,Mississippi,909,8,90,98,Winston 
80,Yalobusha County,Mississippi,485,29,0,29,Yalobusha 
81,Yazoo County,Mississippi,1239,108,141,249,Yazoo 
0,Adams County,Colorado,26753,1746,527,2273,Adams 
1,Alamosa County,Colorado,1297,9,0,9,Alamosa 
2,Arapahoe County,Colorado,31727,1070,811,1881,Arapahoe 
3,Archuleta County,Colorado,514,191,0,191,Archuleta 
4,Baca County,Colorado,95,0,0,0,Baca 
5,Bent County,Colorado,117,9,2,11,Bent 
6,Boulder County,Colorado,21282,154,414,568,Boulder 
7,Broomfield County,Colorado,3520,164,35,199,Broomfield 
8,Chaffee County,Colorado,781,134,22,156,Chaffee 
9,Cheyenne County,Colorado,68,0,0,0,Cheyenne 
10,Clear Creek County,Colorado,659,0,124,124,Clear Creek 
11,Conejos County,Colorado,471,79,3,82,Conejos 
12,Costilla County,Colorado,227,0,0,0,Costilla 
13,Crowley County,Colorado,453,0,0,0,Crowley 
14,Custer County,Colorado,236,0,0,0,Custer 
15,Delta County,Colorado,1470,77,22,99,Delta 
16,Denver County,Colorado,27758,1445,885,2330,Denver 
17,Dolores County,Colorado,74,0,2,2,Dolores 
18,Douglas County,Colorado,19985,347,83,430,Douglas 
19,Eagle County,Colorado,2625,19,17,36,Eagle 
20,Elbert County,Colorado,1325,35,51,86,Elbert 
21,El Paso County,Colorado,38202,1096,676,1772,El Paso 
22,Fremont County,Colorado,1570,4,25,29,Fremont 
23,Garfield County,Colorado,3086,56,0,56,Garfield 
24,Gilpin County,Colorado,244,0,0,0,Gilpin 
25,Grand County,Colorado,609,0,0,0,Grand 
26,Gunnison County,Colorado,1206,32,0,32,Gunnison 
27,Hinsdale County,Colorado,11,0,0,0,Hinsdale 
28,Huerfano County,Colorado,286,6,13,19,Huerfano 
29,Jackson County,Colorado,66,0,0,0,Jackson 
30,Jefferson County,Colorado,26193,606,657,1263,Jefferson 
31,Kiowa County,Colorado,33,0,2,2,Kiowa 
32,Kit Carson County,Colorado,326,64,3,67,Kit Carson 
33,Lake County,Colorado,367,96,0,96,Lake 
34,La Plata County,Colorado,2923,101,108,209,La Plata 
35,Larimer County,Colorado,21028,588,490,1078,Larimer 
36,Las Animas County,Colorado,694,67,0,67,Las Animas 
37,Lincoln County,Colorado,143,1,0,1,Lincoln 
38,Logan County,Colorado,1207,88,0,88,Logan 
39,Mesa County,Colorado,8308,419,222,641,Mesa 
40,Mineral County,Colorado,21,0,0,0,Mineral 
41,Moffat County,Colorado,622,52,38,90,Moffat 
42,Montezuma County,Colorado,1040,47,92,139,Montezuma 
43,Montrose County,Colorado,1879,108,25,133,Montrose 
44,Morgan County,Colorado,1620,145,98,243,Morgan 
45,Otero County,Colorado,1392,211,0,211,Otero 
46,Ouray County,Colorado,115,0,0,0,Ouray 
47,Park County,Colorado,535,0,34,34,Park 
48,Phillips County,Colorado,184,0,1,1,Phillips 
49,Pitkin County,Colorado,824,66,50,116,Pitkin 
50,Prowers County,Colorado,785,30,0,30,Prowers 
51,Pueblo County,Colorado,8532,341,263,604,Pueblo 
52,Rio Blanco County,Colorado,369,1,0,1,Rio Blanco 
53,Rio Grande County,Colorado,740,15,17,32,Rio Grande 
54,Routt County,Colorado,1103,0,0,0,Routt 
55,Saguache County,Colorado,251,1,0,1,Saguache 
56,San Juan County,Colorado,10,0,0,0,San Juan 
57,San Miguel County,Colorado,263,1,0,1,San Miguel 
58,Sedgwick County,Colorado,110,19,0,19,Sedgwick 
59,Summit County,Colorado,969,52,0,52,Summit 
60,Teller County,Colorado,823,0,0,0,Teller 
61,Washington County,Colorado,255,11,4,15,Washington 
62,Weld County,Colorado,18073,638,417,1055,Weld 
63,Yuma County,Colorado,335,0,4,4,Yuma 
0,Anderson County,Texas,2316,94,66,160,Anderson 
1,Andrews County,Texas,1141,20,34,54,Andrews 
2,Angelina County,Texas,4580,88,56,144,Angelina 
3,Aransas County,Texas,1315,67,3,70,Aransas 
4,Archer County,Texas,466,6,0,6,Archer 
5,Armstrong County,Texas,80,0,0,0,Armstrong 
6,Atascosa County,Texas,2969,183,246,429,Atascosa 
7,Austin County,Texas,1439,46,0,46,Austin 
8,Bailey County,Texas,379,0,44,44,Bailey 
9,Bandera County,Texas,798,0,0,0,Bandera 
10,Bastrop County,Texas,4506,22,100,122,Bastrop 
11,Baylor County,Texas,117,0,0,0,Baylor 
12,Bee County,Texas,1741,105,74,179,Bee 
13,Bell County,Texas,19979,605,463,1068,Bell 
14,Bexar County,Texas,114699,3785,2284,6069,Bexar 
15,Blanco County,Texas,519,0,45,45,Blanco 
16,Borden County,Texas,23,0,0,0,Borden 
17,Bosque County,Texas,920,52,0,52,Bosque 
18,Bowie County,Texas,4425,238,51,289,Bowie 
19,Brazoria County,Texas,20037,360,360,720,Brazoria 
20,Brazos County,Texas,20066,269,392,661,Brazos 
21,Brewster County,Texas,344,2,0,2,Brewster 
22,Briscoe County,Texas,52,0,0,0,Briscoe 
23,Brooks County,Texas,253,10,4,14,Brooks 
24,Brown County,Texas,2343,26,35,61,Brown 
25,Burleson County,Texas,923,0,0,0,Burleson 
26,Burnet County,Texas,2673,135,234,369,Burnet 
27,Caldwell County,Texas,2916,87,114,201,Caldwell 
28,Calhoun County,Texas,1422,160,130,290,Calhoun 
29,Callahan County,Texas,747,6,0,6,Callahan 
30,Cameron County,Texas,28937,1625,605,2230,Cameron 
31,Camp County,Texas,555,0,4,4,Camp 
32,Carson County,Texas,403,0,48,48,Carson 
33,Cass County,Texas,1540,10,10,20,Cass 
34,Castro County,Texas,589,32,0,32,Castro 
35,Chambers County,Texas,2389,129,0,129,Chambers 
36,Cherokee County,Texas,2946,194,201,395,Cherokee 
37,Childress County,Texas,216,5,0,5,Childress 
38,Clay County,Texas,435,1,0,1,Clay 
39,Cochran County,Texas,187,13,36,49,Cochran 
40,Coke County,Texas,118,1,20,21,Coke 
41,Coleman County,Texas,427,42,35,77,Coleman 
42,Collin County,Texas,54962,1074,466,1540,Collin 
43,Collingsworth County,Texas,160,14,0,14,Collingsworth 
44,Colorado County,Texas,1511,86,17,103,Colorado 
45,Comal County,Texas,7499,285,257,542,Comal 
46,Comanche County,Texas,637,40,0,40,Comanche 
47,Concho County,Texas,89,4,0,4,Concho 
48,Cooke County,Texas,2054,3,37,40,Cooke 
49,Coryell County,Texas,3570,156,53,209,Coryell 
50,Cottle County,Texas,115,16,0,16,Cottle 
51,Crane County,Texas,390,0,0,0,Crane 
52,Crockett County,Texas,162,0,0,0,Crockett 
53,Crosby County,Texas,386,22,0,22,Crosby 
54,Culberson County,Texas,92,0,82,82,Culberson 
55,Dallam County,Texas,392,28,5,33,Dallam 
56,Dallas County,Texas,141442,6165,3440,9605,Dallas 
57,Dawson County,Texas,719,86,4,90,Dawson 
58,Deaf Smith County,Texas,1140,20,23,43,Deaf Smith 
59,Delta County,Texas,465,61,0,61,Delta 
60,Denton County,Texas,49211,1098,506,1604,Denton 
61,DeWitt County,Texas,927,48,0,48,DeWitt 
62,Dickens County,Texas,115,0,0,0,Dickens 
63,Dimmit County,Texas,810,47,0,47,Dimmit 
64,Donley County,Texas,265,34,0,34,Donley 
65,Duval County,Texas,688,35,42,77,Duval 
66,Eastland County,Texas,1181,28,11,39,Eastland 
67,Ector County,Texas,9540,728,180,908,Ector 
68,Edwards County,Texas,120,0,0,0,Edwards 
69,Ellis County,Texas,10365,334,240,574,Ellis 
70,El Paso County,Texas,51026,1167,692,1859,El Paso 
71,Erath County,Texas,4066,6,0,6,Erath 
72,Falls County,Texas,812,25,73,98,Falls 
73,Fannin County,Texas,1680,25,13,38,Fannin 
74,Fayette County,Texas,1006,8,64,72,Fayette 
75,Fisher County,Texas,108,3,2,5,Fisher 
76,Floyd County,Texas,253,32,0,32,Floyd 
77,Foard County,Texas,89,0,0,0,Foard 
78,Fort Bend County,Texas,44238,629,353,982,Fort Bend 
79,Franklin County,Texas,598,65,5,70,Franklin 
80,Freestone County,Texas,973,45,49,94,Freestone 
81,Frio County,Texas,1693,30,46,76,Frio 
82,Gaines County,Texas,1426,354,77,431,Gaines 
83,Galveston County,Texas,18415,528,274,802,Galveston 
84,Garza County,Texas,329,12,0,12,Garza 
85,Gillespie County,Texas,1357,128,23,151,Gillespie 
86,Glasscock County,Texas,198,0,6,6,Glasscock 
87,Goliad County,Texas,222,7,0,7,Goliad 
88,Gonzales County,Texas,1019,123,13,136,Gonzales 
89,Gray County,Texas,1040,32,24,56,Gray 
90,Grayson County,Texas,6838,85,88,173,Grayson 
91,Gregg County,Texas,6758,201,165,366,Gregg 
92,Grimes County,Texas,1474,191,56,247,Grimes 
93,Guadalupe County,Texas,8844,133,120,253,Guadalupe 
94,Hale County,Texas,2040,57,102,159,Hale 
95,Hall County,Texas,190,1,2,3,Hall 
96,Hamilton County,Texas,636,40,0,40,Hamilton 
97,Hansford County,Texas,288,23,0,23,Hansford 
98,Hardeman County,Texas,141,8,19,27,Hardeman 
99,Hardin County,Texas,2920,34,49,83,Hardin 
100,Harris County,Texas,253685,9086,6632,15718,Harris 
101,Harrison County,Texas,3774,186,44,230,Harrison 
102,Hartley County,Texas,129,6,1,7,Hartley 
103,Haskell County,Texas,409,6,0,6,Haskell 
104,Hays County,Texas,15327,257,114,371,Hays 
105,Hemphill County,Texas,249,0,0,0,Hemphill 
106,Henderson County,Texas,3963,192,70,262,Henderson 
107,Hidalgo County,Texas,59782,1903,1473,3376,Hidalgo 
108,Hill County,Texas,2046,60,29,89,Hill 
109,Hockley County,Texas,1526,65,16,81,Hockley 
110,Hood County,Texas,2593,59,81,140,Hood 
111,Hopkins County,Texas,1758,23,46,69,Hopkins 
112,Houston County,Texas,1017,35,44,79,Houston 
113,Howard County,Texas,2184,129,9,138,Howard 
114,Hudspeth County,Texas,243,10,0,10,Hudspeth 
115,Hunt County,Texas,5880,156,199,355,Hunt 
116,Hutchinson County,Texas,1454,18,12,30,Hutchinson 
117,Irion County,Texas,102,0,0,0,Irion 
118,Jack County,Texas,627,35,0,35,Jack 
119,Jackson County,Texas,781,0,0,0,Jackson 
120,Jasper County,Texas,1985,51,66,117,Jasper 
121,Jeff Davis County,Texas,61,0,0,0,Jeff Davis 
122,Jefferson County,Texas,12766,503,395,898,Jefferson 
123,Jim Hogg County,Texas,368,60,147,207,Jim Hogg 
124,Jim Wells County,Texas,2062,122,144,266,Jim Wells 
125,Johnson County,Texas,9754,979,731,1710,Johnson 
126,Jones County,Texas,732,51,93,144,Jones 
127,Karnes County,Texas,849,24,53,77,Karnes 
128,Kaufman County,Texas,7321,131,118,249,Kaufman 
129,Kendall County,Texas,2380,0,0,0,Kendall 
130,Kenedy County,Texas,0,0,0,0,Kenedy 
131,Kent County,Texas,35,0,0,0,Kent 
132,Kerr County,Texas,2371,68,49,117,Kerr 
133,Kimble County,Texas,255,9,14,23,Kimble 
134,King County,Texas,3,0,0,0,King 
135,Kinney County,Texas,54,0,0,0,Kinney 
136,Kleberg County,Texas,2469,131,0,131,Kleberg 
137,Knox County,Texas,194,19,0,19,Knox 
138,Lamar County,Texas,2436,129,135,264,Lamar 
139,Lamb County,Texas,690,3,4,7,Lamb 
140,Lampasas County,Texas,1129,60,10,70,Lampasas 
141,La Salle County,Texas,404,66,6,72,La Salle 
142,Lavaca County,Texas,1003,10,0,10,Lavaca 
143,Lee County,Texas,1028,4,0,4,Lee 
144,Leon County,Texas,742,33,59,92,Leon 
145,Liberty County,Texas,4485,184,85,269,Liberty 
146,Limestone County,Texas,1105,52,40,92,Limestone 
147,Lipscomb County,Texas,218,44,12,56,Lipscomb 
148,Live Oak County,Texas,686,21,134,155,Live Oak 
149,Llano County,Texas,772,140,46,186,Llano 
150,Loving County,Texas,0,0,0,0,Loving 
151,Lubbock County,Texas,22117,357,273,630,Lubbock 
152,Lynn County,Texas,290,10,0,10,Lynn 
153,McCulloch County,Texas,278,0,0,0,McCulloch 
154,McLennan County,Texas,17252,569,89,658,McLennan 
155,McMullen County,Texas,9,0,0,0,McMullen 
156,Madison County,Texas,571,61,0,61,Madison 
157,Marion County,Texas,366,28,0,28,Marion 
158,Martin County,Texas,391,48,44,92,Martin 
159,Mason County,Texas,287,0,0,0,Mason 
160,Matagorda County,Texas,2008,0,18,18,Matagorda 
161,Maverick County,Texas,4199,209,43,252,Maverick 
162,Medina County,Texas,3180,61,0,61,Medina 
163,Menard County,Texas,81,0,0,0,Menard 
164,Midland County,Texas,8649,297,245,542,Midland 
165,Milam County,Texas,1262,132,4,136,Milam 
166,Mills County,Texas,297,1,0,1,Mills 
167,Mitchell County,Texas,506,43,0,43,Mitchell 
168,Montague County,Texas,717,60,16,76,Montague 
169,Montgomery County,Texas,33081,970,798,1768,Montgomery 
170,Moore County,Texas,1148,199,26,225,Moore 
171,Morris County,Texas,583,7,7,14,Morris 
172,Motley County,Texas,54,0,0,0,Motley 
173,Nacogdoches County,Texas,5501,80,8,88,Nacogdoches 
174,Navarro County,Texas,2843,272,24,296,Navarro 
175,Newton County,Texas,965,95,30,125,Newton 
176,Nolan County,Texas,1122,199,88,287,Nolan 
177,Nueces County,Texas,20532,1338,673,2011,Nueces 
178,Ochiltree County,Texas,674,28,11,39,Ochiltree 
179,Oldham County,Texas,161,8,0,8,Oldham 
180,Orange County,Texas,4355,133,120,253,Orange 
181,Palo Pinto County,Texas,1409,7,6,13,Palo Pinto 
182,Panola County,Texas,1165,19,7,26,Panola 
183,Parker County,Texas,7288,203,76,279,Parker 
184,Parmer County,Texas,544,30,16,46,Parmer 
185,Pecos County,Texas,752,0,56,56,Pecos 
186,Polk County,Texas,2318,140,129,269,Polk 
187,Potter County,Texas,6296,125,314,439,Potter 
188,Presidio County,Texas,655,226,14,240,Presidio 
189,Rains County,Texas,488,25,40,65,Rains 
190,Randall County,Texas,7863,536,261,797,Randall 
191,Reagan County,Texas,155,20,0,20,Reagan 
192,Real County,Texas,266,0,0,0,Real 
193,Red River County,Texas,624,30,0,30,Red River 
194,Reeves County,Texas,1113,87,0,87,Reeves 
195,Refugio County,Texas,356,5,0,5,Refugio 
196,Roberts County,Texas,53,0,0,0,Roberts 
197,Robertson County,Texas,718,19,0,19,Robertson 
198,Rockwall County,Texas,5979,47,76,123,Rockwall 
199,Runnels County,Texas,439,2,32,34,Runnels 
200,Rusk County,Texas,2755,225,63,288,Rusk 
201,Sabine County,Texas,575,0,10,10,Sabine 
202,San Augustine County,Texas,410,5,39,44,San Augustine 
203,San Jacinto County,Texas,1017,0,38,38,San Jacinto 
204,San Patricio County,Texas,3799,110,46,156,San Patricio 
205,San Saba County,Texas,310,0,0,0,San Saba 
206,Schleicher County,Texas,147,0,0,0,Schleicher 
207,Scurry County,Texas,1095,23,138,161,Scurry 
208,Shackelford County,Texas,207,20,41,61,Shackelford 
209,Shelby County,Texas,1537,30,0,30,Shelby 
210,Sherman County,Texas,156,23,0,23,Sherman 
211,Smith County,Texas,12830,675,359,1034,Smith 
212,Somervell County,Texas,265,0,0,0,Somervell 
213,Starr County,Texas,4553,115,304,419,Starr 
214,Stephens County,Texas,513,4,0,4,Stephens 
215,Sterling County,Texas,82,0,0,0,Sterling 
216,Stonewall County,Texas,110,0,0,0,Stonewall 
217,Sutton County,Texas,143,0,0,0,Sutton 
218,Swisher County,Texas,356,15,0,15,Swisher 
219,Tarrant County,Texas,120025,5009,2930,7939,Tarrant 
220,Taylor County,Texas,8422,355,247,602,Taylor 
221,Terrell County,Texas,23,0,0,0,Terrell 
222,Terry County,Texas,760,20,29,49,Terry 
223,Throckmorton County,Texas,99,0,0,0,Throckmorton 
224,Titus County,Texas,1964,5,23,28,Titus 
225,Tom Green County,Texas,7557,121,146,267,Tom Green 
226,Travis County,Texas,61459,1994,1235,3229,Travis 
227,Trinity County,Texas,658,20,0,20,Trinity 
228,Tyler County,Texas,955,151,0,151,Tyler 
229,Upshur County,Texas,2206,67,22,89,Upshur 
230,Upton County,Texas,222,2,0,2,Upton 
231,Uvalde County,Texas,2071,35,60,95,Uvalde 
232,Val Verde County,Texas,2949,194,56,250,Val Verde 
233,Van Zandt County,Texas,2851,18,103,121,Van Zandt 
234,Victoria County,Texas,4821,158,185,343,Victoria 
235,Walker County,Texas,5676,70,0,70,Walker 
236,Waller County,Texas,5059,319,128,447,Waller 
237,Ward County,Texas,577,0,40,40,Ward 
238,Washington County,Texas,2933,5,107,112,Washington 
239,Webb County,Texas,19169,495,232,727,Webb 
240,Wharton County,Texas,2408,188,103,291,Wharton 
241,Wheeler County,Texas,279,47,0,47,Wheeler 
242,Wichita County,Texas,8955,156,226,382,Wichita 
243,Wilbarger County,Texas,744,107,134,241,Wilbarger 
244,Willacy County,Texas,1305,58,68,126,Willacy 
245,Williamson County,Texas,29269,646,894,1540,Williamson 
246,Wilson County,Texas,2822,161,14,175,Wilson 
247,Winkler County,Texas,817,38,0,38,Winkler 
248,Wise County,Texas,4025,131,71,202,Wise 
249,Wood County,Texas,2008,129,110,239,Wood 
250,Yoakum County,Texas,468,146,7,153,Yoakum 
251,Young County,Texas,836,0,6,6,Young 
252,Zapata County,Texas,819,76,0,76,Zapata 
253,Zavala County,Texas,825,23,10,33,Zavala 
0,Abbeville County,South Carolina,1390,50,38,88,Abbeville 
1,Aiken County,South Carolina,7783,328,104,432,Aiken 
2,Allendale County,South Carolina,620,132,22,154,Allendale 
3,Anderson County,South Carolina,10256,601,454,1055,Anderson 
4,Bamberg County,South Carolina,1072,0,0,0,Bamberg 
5,Barnwell County,South Carolina,1263,21,108,129,Barnwell 
6,Beaufort County,South Carolina,9283,281,44,325,Beaufort 
7,Berkeley County,South Carolina,11366,243,114,357,Berkeley 
8,Calhoun County,South Carolina,566,12,0,12,Calhoun 
9,Charleston County,South Carolina,18684,742,317,1059,Charleston 
10,Cherokee County,South Carolina,3392,237,77,314,Cherokee 
11,Chester County,South Carolina,1770,49,182,231,Chester 
12,Chesterfield County,South Carolina,2326,311,27,338,Chesterfield 
13,Clarendon County,South Carolina,1557,74,39,113,Clarendon 
14,Colleton County,South Carolina,1852,108,5,113,Colleton 
15,Darlington County,South Carolina,3564,524,120,644,Darlington 
16,Dillon County,South Carolina,1372,83,38,121,Dillon 
17,Dorchester County,South Carolina,8846,484,362,846,Dorchester 
18,Edgefield County,South Carolina,1558,40,34,74,Edgefield 
19,Fairfield County,South Carolina,1068,15,0,15,Fairfield 
20,Florence County,South Carolina,7126,160,54,214,Florence 
21,Georgetown County,South Carolina,2547,60,40,100,Georgetown 
22,Greenville County,South Carolina,26168,803,562,1365,Greenville 
23,Greenwood County,South Carolina,3924,252,318,570,Greenwood 
24,Hampton County,South Carolina,932,0,15,15,Hampton 
25,Horry County,South Carolina,15476,625,227,852,Horry 
26,Jasper County,South Carolina,1445,7,49,56,Jasper 
27,Kershaw County,South Carolina,3346,178,104,282,Kershaw 
28,Lancaster County,South Carolina,3918,181,161,342,Lancaster 
29,Laurens County,South Carolina,3217,95,95,190,Laurens 
30,Lee County,South Carolina,901,0,37,37,Lee 
31,Lexington County,South Carolina,13766,616,199,815,Lexington 
32,McCormick County,South Carolina,290,43,12,55,McCormick 
33,Marion County,South Carolina,1775,59,93,152,Marion 
34,Marlboro County,South Carolina,1020,204,0,204,Marlboro 
35,Newberry County,South Carolina,2279,31,111,142,Newberry 
36,Oconee County,South Carolina,3373,174,88,262,Oconee 
37,Orangeburg County,South Carolina,4965,92,188,280,Orangeburg 
38,Pickens County,South Carolina,10239,277,291,568,Pickens 
39,Richland County,South Carolina,31457,663,550,1213,Richland 
40,Saluda County,South Carolina,968,130,153,283,Saluda 
41,Spartanburg County,South Carolina,16965,460,456,916,Spartanburg 
42,Sumter County,South Carolina,5485,103,0,103,Sumter 
43,Union County,South Carolina,1170,33,83,116,Union 
44,Williamsburg County,South Carolina,1444,71,2,73,Williamsburg 
45,York County,South Carolina,14653,394,66,460,York 
0,Barbour County,West Virginia,1120,25,13,38,Barbour 
1,Berkeley County,West Virginia,4925,207,126,333,Berkeley 
2,Boone County,West Virginia,1105,44,84,128,Boone 
3,Braxton County,West Virginia,605,11,2,13,Braxton 
4,Brooke County,West Virginia,1397,28,15,43,Brooke 
5,Cabell County,West Virginia,5034,241,89,330,Cabell 
6,Calhoun County,West Virginia,226,0,0,0,Calhoun 
7,Clay County,West Virginia,471,14,0,14,Clay 
8,Doddridge County,West Virginia,552,0,30,30,Doddridge 
9,Fayette County,West Virginia,1972,1,21,22,Fayette 
10,Gilmer County,West Virginia,691,0,0,0,Gilmer 
11,Grant County,West Virginia,506,0,0,0,Grant 
12,Greenbrier County,West Virginia,1309,3,24,27,Greenbrier 
13,Hampshire County,West Virginia,997,3,11,14,Hampshire 
14,Hancock County,West Virginia,1225,48,68,116,Hancock 
15,Hardy County,West Virginia,499,0,7,7,Hardy 
16,Harrison County,West Virginia,2917,142,22,164,Harrison 
17,Jackson County,West Virginia,1419,40,82,122,Jackson 
18,Jefferson County,West Virginia,3053,34,35,69,Jefferson 
19,Kanawha County,West Virginia,8066,221,325,546,Kanawha 
20,Lewis County,West Virginia,800,0,0,0,Lewis 
21,Lincoln County,West Virginia,786,17,0,17,Lincoln 
22,Logan County,West Virginia,1461,25,20,45,Logan 
23,McDowell County,West Virginia,737,59,27,86,McDowell 
24,Marion County,West Virginia,2923,53,56,109,Marion 
25,Marshall County,West Virginia,1255,0,8,8,Marshall 
26,Mason County,West Virginia,1186,24,5,29,Mason 
27,Mercer County,West Virginia,2940,10,6,16,Mercer 
28,Mineral County,West Virginia,1615,3,22,25,Mineral 
29,Mingo County,West Virginia,1086,15,57,72,Mingo 
30,Monongalia County,West Virginia,7932,23,18,41,Monongalia 
31,Monroe County,West Virginia,554,0,0,0,Monroe 
32,Morgan County,West Virginia,1098,94,0,94,Morgan 
33,Nicholas County,West Virginia,1042,0,0,0,Nicholas 
34,Ohio County,West Virginia,2524,78,34,112,Ohio 
35,Pendleton County,West Virginia,225,0,0,0,Pendleton 
36,Pleasants County,West Virginia,387,8,0,8,Pleasants 
37,Pocahontas County,West Virginia,360,0,19,19,Pocahontas 
38,Preston County,West Virginia,1307,25,0,25,Preston 
39,Putnam County,West Virginia,2791,16,37,53,Putnam 
40,Raleigh County,West Virginia,3198,160,36,196,Raleigh 
41,Randolph County,West Virginia,1287,47,13,60,Randolph 
42,Ritchie County,West Virginia,373,0,4,4,Ritchie 
43,Roane County,West Virginia,714,95,38,133,Roane 
44,Summers County,West Virginia,457,18,0,18,Summers 
45,Taylor County,West Virginia,603,0,2,2,Taylor 
46,Tucker County,West Virginia,307,0,5,5,Tucker 
47,Tyler County,West Virginia,428,20,0,20,Tyler 
48,Upshur County,West Virginia,1386,59,4,63,Upshur 
49,Wayne County,West Virginia,1942,96,170,266,Wayne 
50,Webster County,West Virginia,327,5,28,33,Webster 
51,Wetzel County,West Virginia,678,2,86,88,Wetzel 
52,Wirt County,West Virginia,232,0,11,11,Wirt 
53,Wood County,West Virginia,3916,124,67,191,Wood 
54,Wyoming County,West Virginia,1036,41,70,111,Wyoming 
0,Beaverhead County,Montana,743,0,28,28,Beaverhead 
1,Big Horn County,Montana,870,29,59,88,Big Horn 
2,Blaine County,Montana,307,2,5,7,Blaine 
3,Broadwater County,Montana,328,39,63,102,Broadwater 
4,Carbon County,Montana,424,14,16,30,Carbon 
5,Carter County,Montana,40,12,6,18,Carter 
6,Cascade County,Montana,3468,80,84,164,Cascade 
7,Chouteau County,Montana,228,24,26,50,Chouteau 
8,Custer County,Montana,625,32,24,56,Custer 
9,Daniels County,Montana,70,0,0,0,Daniels 
10,Dawson County,Montana,421,5,2,7,Dawson 
11,Deer Lodge County,Montana,508,117,9,126,Deer Lodge 
12,Fallon County,Montana,131,0,0,0,Fallon 
13,Fergus County,Montana,468,5,1,6,Fergus 
14,Flathead County,Montana,4637,142,135,277,Flathead 
15,Gallatin County,Montana,6621,128,78,206,Gallatin 
16,Garfield County,Montana,41,0,18,18,Garfield 
17,Glacier County,Montana,609,16,19,35,Glacier 
18,Golden Valley County,Montana,31,3,0,3,Golden Valley 
19,Granite County,Montana,216,0,21,21,Granite 
20,Hill County,Montana,951,0,0,0,Hill 
21,Jefferson County,Montana,580,0,38,38,Jefferson 
22,Judith Basin County,Montana,94,0,0,0,Judith Basin 
23,Lake County,Montana,1423,139,108,247,Lake 
24,Lewis and Clark County,Montana,3184,248,190,438,Lewis and Clark 
25,Liberty County,Montana,155,0,35,35,Liberty 
26,Lincoln County,Montana,687,36,6,42,Lincoln 
27,McCone County,Montana,44,0,0,0,McCone 
28,Madison County,Montana,338,0,0,0,Madison 
29,Meagher County,Montana,41,0,0,0,Meagher 
30,Mineral County,Montana,173,0,0,0,Mineral 
31,Missoula County,Montana,6914,76,26,102,Missoula 
32,Musselshell County,Montana,187,23,9,32,Musselshell 
33,Park County,Montana,541,70,0,70,Park 
34,Petroleum County,Montana,19,0,0,0,Petroleum 
35,Phillips County,Montana,160,0,0,0,Phillips 
36,Pondera County,Montana,370,4,39,43,Pondera 
37,Powder River County,Montana,42,0,0,0,Powder River 
38,Powell County,Montana,301,56,6,62,Powell 
39,Prairie County,Montana,43,0,0,0,Prairie 
40,Ravalli County,Montana,1946,155,89,244,Ravalli 
41,Richland County,Montana,733,2,0,2,Richland 
42,Roosevelt County,Montana,687,53,69,122,Roosevelt 
43,Rosebud County,Montana,562,35,18,53,Rosebud 
44,Sanders County,Montana,449,5,20,25,Sanders 
45,Sheridan County,Montana,103,0,0,0,Sheridan 
46,Silver Bow County,Montana,1586,136,8,144,Silver Bow 
47,Stillwater County,Montana,480,8,5,13,Stillwater 
48,Sweet Grass County,Montana,98,10,1,11,Sweet Grass 
49,Teton County,Montana,312,8,0,8,Teton 
50,Toole County,Montana,225,8,0,8,Toole 
51,Treasure County,Montana,27,0,17,17,Treasure 
52,Valley County,Montana,344,0,0,0,Valley 
53,Wheatland County,Montana,105,30,0,30,Wheatland 
54,Wibaux County,Montana,52,0,0,0,Wibaux 
55,Yellowstone County,Montana,7447,505,317,822,Yellowstone 
0,Beaver County,Utah,501,20,20,40,Beaver 
1,Box Elder County,Utah,3360,100,47,147,Box Elder 
2,Cache County,Utah,9617,302,192,494,Cache 
3,Carbon County,Utah,1266,6,31,37,Carbon 
4,Daggett County,Utah,26,0,0,0,Daggett 
5,Davis County,Utah,21758,597,612,1209,Davis 
6,Duchesne County,Utah,1165,47,65,112,Duchesne 
7,Emery County,Utah,579,22,0,22,Emery 
8,Garfield County,Utah,334,1,11,12,Garfield 
9,Grand County,Utah,285,0,14,14,Grand 
10,Iron County,Utah,4171,103,177,280,Iron 
11,Juab County,Utah,781,61,17,78,Juab 
12,Kane County,Utah,313,33,0,33,Kane 
13,Millard County,Utah,798,102,2,104,Millard 
14,Morgan County,Utah,739,16,0,16,Morgan 
15,Piute County,Utah,156,20,0,20,Piute 
16,Rich County,Utah,174,0,0,0,Rich 
17,Salt Lake County,Utah,62946,2769,1627,4396,Salt Lake 
18,San Juan County,Utah,1051,10,0,10,San Juan 
19,Sanpete County,Utah,2716,82,2,84,Sanpete 
20,Sevier County,Utah,1203,129,60,189,Sevier 
21,Summit County,Utah,2505,91,170,261,Summit 
22,Tooele County,Utah,4795,151,342,493,Tooele 
23,Uintah County,Utah,2113,124,54,178,Uintah 
24,Utah County,Utah,47313,913,489,1402,Utah 
25,Wasatch County,Utah,1999,164,5,169,Wasatch 
26,Washington County,Utah,9754,405,193,598,Washington 
27,Wayne County,Utah,186,0,0,0,Wayne 
28,Weber County,Utah,13951,499,475,974,Weber 
0,Autauga County,Alabama,3042,9,104,113,Autauga 
1,Baldwin County,Alabama,10258,500,127,627,Baldwin 
2,Barbour County,Alabama,1078,17,23,40,Barbour 
3,Bibb County,Alabama,1147,29,98,127,Bibb 
4,Blount County,Alabama,3071,118,24,142,Blount 
5,Bullock County,Alabama,881,29,68,97,Bullock 
6,Butler County,Alabama,865,96,132,228,Butler 
7,Calhoun County,Alabama,6350,179,191,370,Calhoun 
8,Chambers County,Alabama,1374,124,48,172,Chambers 
9,Cherokee County,Alabama,1213,56,8,64,Cherokee 
10,Chilton County,Alabama,2099,7,0,7,Chilton 
11,Choctaw County,Alabama,830,0,0,0,Choctaw 
12,Clarke County,Alabama,1335,93,60,153,Clarke 
13,Clay County,Alabama,683,17,32,49,Clay 
14,Cleburne County,Alabama,674,25,27,52,Cleburne 
15,Coffee County,Alabama,2531,32,58,90,Coffee 
16,Colbert County,Alabama,2528,173,63,236,Colbert 
17,Conecuh County,Alabama,693,4,0,4,Conecuh 
18,Coosa County,Alabama,321,56,0,56,Coosa 
19,Covington County,Alabama,1698,49,23,72,Covington 
20,Crenshaw County,Alabama,607,11,0,11,Crenshaw 
21,Cullman County,Alabama,4134,303,135,438,Cullman 
22,Dale County,Alabama,2373,105,41,146,Dale 
23,Dallas County,Alabama,2125,84,32,116,Dallas 
24,DeKalb County,Alabama,3890,220,51,271,DeKalb 
25,Elmore County,Alabama,3939,100,65,165,Elmore 
26,Escambia County,Alabama,1876,162,75,237,Escambia 
27,Etowah County,Alabama,4690,190,38,228,Etowah 
28,Fayette County,Alabama,918,0,0,0,Fayette 
29,Franklin County,Alabama,1424,32,10,42,Franklin 
30,Geneva County,Alabama,1306,64,54,118,Geneva 
31,Greene County,Alabama,159,0,0,0,Greene 
32,Hale County,Alabama,860,36,92,128,Hale 
33,Henry County,Alabama,999,41,42,83,Henry 
34,Houston County,Alabama,4938,80,111,191,Houston 
35,Jackson County,Alabama,2326,16,95,111,Jackson 
36,Jefferson County,Alabama,33375,689,1007,1696,Jefferson 
37,Lamar County,Alabama,450,34,10,44,Lamar 
38,Lauderdale County,Alabama,4752,51,42,93,Lauderdale 
39,Lawrence County,Alabama,1573,22,0,22,Lawrence 
40,Lee County,Alabama,11838,298,265,563,Lee 
41,Limestone County,Alabama,4834,99,156,255,Limestone 
42,Lowndes County,Alabama,424,32,12,44,Lowndes 
43,Macon County,Alabama,1635,101,30,131,Macon 
44,Madison County,Alabama,19034,346,154,500,Madison 
45,Marengo County,Alabama,1007,13,0,13,Marengo 
46,Marion County,Alabama,1530,105,108,213,Marion 
47,Marshall County,Alabama,5096,100,165,265,Marshall 
48,Mobile County,Alabama,21261,916,355,1271,Mobile 
49,Monroe County,Alabama,1252,19,54,73,Monroe 
50,Montgomery County,Alabama,12150,420,225,645,Montgomery 
51,Morgan County,Alabama,5668,213,120,333,Morgan 
52,Perry County,Alabama,1086,1,0,1,Perry 
53,Pickens County,Alabama,1005,3,95,98,Pickens 
54,Pike County,Alabama,3016,39,32,71,Pike 
55,Randolph County,Alabama,1108,24,0,24,Randolph 
56,Russell County,Alabama,2558,228,57,285,Russell 
57,St. Clair County,Alabama,3817,214,70,284,St. Clair 
58,Shelby County,Alabama,11693,262,55,317,Shelby 
59,Sumter County,Alabama,974,12,38,50,Sumter 
60,Talladega County,Alabama,4008,125,128,253,Talladega 
61,Tallapoosa County,Alabama,2103,307,79,386,Tallapoosa 
62,Tuscaloosa County,Alabama,16681,116,122,238,Tuscaloosa 
63,Walker County,Alabama,2915,58,33,91,Walker 
64,Washington County,Alabama,1111,10,13,23,Washington 
65,Wilcox County,Alabama,638,4,8,12,Wilcox 
66,Winston County,Alabama,1049,194,73,267,Winston 
0,Anderson County,Tennessee,3221,115,74,189,Anderson 
1,Bedford County,Tennessee,2224,59,14,73,Bedford 
2,Benton County,Tennessee,601,96,0,96,Benton 
3,Bledsoe County,Tennessee,468,0,0,0,Bledsoe 
4,Blount County,Tennessee,6566,58,85,143,Blount 
5,Bradley County,Tennessee,6172,314,119,433,Bradley 
6,Campbell County,Tennessee,1550,77,25,102,Campbell 
7,Cannon County,Tennessee,634,13,26,39,Cannon 
8,Carroll County,Tennessee,1377,8,22,30,Carroll 
9,Carter County,Tennessee,2252,26,14,40,Carter 
10,Cheatham County,Tennessee,1961,52,0,52,Cheatham 
11,Chester County,Tennessee,1425,66,0,66,Chester 
12,Claiborne County,Tennessee,1528,44,10,54,Claiborne 
13,Clay County,Tennessee,320,32,0,32,Clay 
14,Cocke County,Tennessee,1627,66,19,85,Cocke 
15,Coffee County,Tennessee,2832,69,54,123,Coffee 
16,Crockett County,Tennessee,767,48,0,48,Crockett 
17,Cumberland County,Tennessee,2215,167,54,221,Cumberland 
18,Davidson County,Tennessee,32170,1080,517,1597,Davidson 
19,Decatur County,Tennessee,481,0,3,3,Decatur 
20,DeKalb County,Tennessee,765,1,2,3,DeKalb 
21,Dickson County,Tennessee,2461,2,43,45,Dickson 
22,Dyer County,Tennessee,1793,12,78,90,Dyer 
23,Fayette County,Tennessee,1773,75,80,155,Fayette 
24,Fentress County,Tennessee,922,7,0,7,Fentress 
25,Franklin County,Tennessee,2565,31,42,73,Franklin 
26,Gibson County,Tennessee,2493,62,37,99,Gibson 
27,Giles County,Tennessee,1636,58,22,80,Giles 
28,Grainger County,Tennessee,1204,0,88,88,Grainger 
29,Greene County,Tennessee,3261,83,20,103,Greene 
30,Grundy County,Tennessee,685,17,0,17,Grundy 
31,Hamblen County,Tennessee,3197,32,4,36,Hamblen 
32,Hamilton County,Tennessee,17885,357,399,756,Hamilton 
33,Hancock County,Tennessee,257,1,0,1,Hancock 
34,Hardeman County,Tennessee,1103,64,8,72,Hardeman 
35,Hardin County,Tennessee,1024,13,0,13,Hardin 
36,Hawkins County,Tennessee,2639,48,62,110,Hawkins 
37,Haywood County,Tennessee,917,76,0,76,Haywood 
38,Henderson County,Tennessee,1265,0,27,27,Henderson 
39,Henry County,Tennessee,1415,98,84,182,Henry 
40,Hickman County,Tennessee,1301,37,94,131,Hickman 
41,Houston County,Tennessee,544,41,0,41,Houston 
42,Humphreys County,Tennessee,995,17,0,17,Humphreys 
43,Jackson County,Tennessee,512,0,0,0,Jackson 
44,Jefferson County,Tennessee,2929,72,18,90,Jefferson 
45,Johnson County,Tennessee,640,51,23,74,Johnson 
46,Knox County,Tennessee,24858,596,823,1419,Knox 
47,Lake County,Tennessee,282,10,0,10,Lake 
48,Lauderdale County,Tennessee,1221,43,15,58,Lauderdale 
49,Lawrence County,Tennessee,2186,175,156,331,Lawrence 
50,Lewis County,Tennessee,628,0,20,20,Lewis 
51,Lincoln County,Tennessee,1632,34,0,34,Lincoln 
52,Loudon County,Tennessee,2234,42,34,76,Loudon 
53,McMinn County,Tennessee,2771,60,48,108,McMinn 
54,McNairy County,Tennessee,1273,49,6,55,McNairy 
55,Macon County,Tennessee,1067,67,0,67,Macon 
56,Madison County,Tennessee,5837,146,152,298,Madison 
57,Marion County,Tennessee,1352,0,111,111,Marion 
58,Marshall County,Tennessee,1808,69,110,179,Marshall 
59,Maury County,Tennessee,4330,78,98,176,Maury 
60,Meigs County,Tennessee,517,25,0,25,Meigs 
61,Monroe County,Tennessee,2218,41,43,84,Monroe 
62,Montgomery County,Tennessee,10563,129,185,314,Montgomery 
63,Moore County,Tennessee,267,15,25,40,Moore 
64,Morgan County,Tennessee,968,0,0,0,Morgan 
65,Obion County,Tennessee,1449,82,0,82,Obion 
66,Overton County,Tennessee,992,102,29,131,Overton 
67,Perry County,Tennessee,368,30,30,60,Perry 
68,Pickett County,Tennessee,157,5,0,5,Pickett 
69,Polk County,Tennessee,673,0,0,0,Polk 
70,Putnam County,Tennessee,4579,123,4,127,Putnam 
71,Rhea County,Tennessee,1786,67,10,77,Rhea 
72,Roane County,Tennessee,2695,20,0,20,Roane 
73,Robertson County,Tennessee,3571,8,14,22,Robertson 
74,Rutherford County,Tennessee,18704,492,161,653,Rutherford 
75,Scott County,Tennessee,1198,0,15,15,Scott 
76,Sequatchie County,Tennessee,820,0,45,45,Sequatchie 
77,Sevier County,Tennessee,4573,238,125,363,Sevier 
78,Shelby County,Tennessee,49179,1652,1144,2796,Shelby 
79,Smith County,Tennessee,986,9,8,17,Smith 
80,Stewart County,Tennessee,707,36,60,96,Stewart 
81,Sullivan County,Tennessee,6901,190,106,296,Sullivan 
82,Sumner County,Tennessee,9305,202,286,488,Sumner 
83,Tipton County,Tennessee,3654,134,25,159,Tipton 
84,Trousdale County,Tennessee,623,50,13,63,Trousdale 
85,Unicoi County,Tennessee,762,85,0,85,Unicoi 
86,Union County,Tennessee,951,98,11,109,Union 
87,Van Buren County,Tennessee,274,4,51,55,Van Buren 
88,Warren County,Tennessee,2120,43,140,183,Warren 
89,Washington County,Tennessee,6969,262,257,519,Washington 
90,Wayne County,Tennessee,567,0,0,0,Wayne 
91,Weakley County,Tennessee,2343,63,23,86,Weakley 
92,White County,Tennessee,1163,35,67,102,White 
93,Williamson County,Tennessee,13817,248,146,394,Williamson 
94,Wilson County,Tennessee,7030,177,108,285,Wilson 
0,Bristol County,Rhode Island,3897,20,18,38,Bristol 
1,Kent County,Rhode Island,6871,156,122,278,Kent 
2,Newport County,Rhode Island,3977,8,1,9,Newport 
3,Providence County,Rhode Island,36784,740,553,1293,Providence 
4,Washington County,Rhode Island,9582,107,156,263,Washington 
0,Arkansas County,Arkansas,895,4,57,61,Arkansas 
1,Ashley County,Arkansas,997,0,37,37,Ashley 
2,Baxter County,Arkansas,1730,99,59,158,Baxter 
3,Benton County,Arkansas,14508,405,249,654,Benton 
4,Boone County,Arkansas,1392,120,31,151,Boone 
5,Bradley County,Arkansas,497,0,25,25,Bradley 
6,Calhoun County,Arkansas,312,14,4,18,Calhoun 
7,Carroll County,Arkansas,1435,88,12,100,Carroll 
8,Chicot County,Arkansas,426,13,0,13,Chicot 
9,Clark County,Arkansas,2311,20,0,20,Clark 
10,Clay County,Arkansas,706,57,20,77,Clay 
11,Cleburne County,Arkansas,1161,34,75,109,Cleburne 
12,Cleveland County,Arkansas,327,4,2,6,Cleveland 
13,Columbia County,Arkansas,1816,8,54,62,Columbia 
14,Conway County,Arkansas,980,33,0,33,Conway 
15,Craighead County,Arkansas,6732,181,223,404,Craighead 
16,Crawford County,Arkansas,3102,79,61,140,Crawford 
17,Crittenden County,Arkansas,2634,37,124,161,Crittenden 
18,Cross County,Arkansas,875,6,9,15,Cross 
19,Dallas County,Arkansas,538,0,0,0,Dallas 
20,Desha County,Arkansas,633,9,11,20,Desha 
21,Drew County,Arkansas,1423,29,0,29,Drew 
22,Faulkner County,Arkansas,7994,292,85,377,Faulkner 
23,Franklin County,Arkansas,957,54,28,82,Franklin 
24,Fulton County,Arkansas,563,49,29,78,Fulton 
25,Garland County,Arkansas,4530,394,119,513,Garland 
26,Grant County,Arkansas,710,15,42,57,Grant 
27,Greene County,Arkansas,2469,160,42,202,Greene 
28,Hempstead County,Arkansas,908,117,6,123,Hempstead 
29,Hot Spring County,Arkansas,1513,40,48,88,Hot Spring 
30,Howard County,Arkansas,774,118,24,142,Howard 
31,Independence County,Arkansas,2073,37,73,110,Independence 
32,Izard County,Arkansas,508,0,1,1,Izard 
33,Jackson County,Arkansas,687,16,16,32,Jackson 
34,Jefferson County,Arkansas,3872,51,43,94,Jefferson 
35,Johnson County,Arkansas,1428,70,26,96,Johnson 
36,Lafayette County,Arkansas,265,0,4,4,Lafayette 
37,Lawrence County,Arkansas,930,24,18,42,Lawrence 
38,Lee County,Arkansas,454,26,7,33,Lee 
39,Lincoln County,Arkansas,423,46,13,59,Lincoln 
40,Little River County,Arkansas,538,0,43,43,Little River 
41,Logan County,Arkansas,979,14,13,27,Logan 
42,Lonoke County,Arkansas,4043,113,34,147,Lonoke 
43,Madison County,Arkansas,824,104,0,104,Madison 
44,Marion County,Arkansas,589,0,0,0,Marion 
45,Miller County,Arkansas,2608,44,6,50,Miller 
46,Mississippi County,Arkansas,2421,35,122,157,Mississippi 
47,Monroe County,Arkansas,351,0,0,0,Monroe 
48,Montgomery County,Arkansas,429,13,0,13,Montgomery 
49,Nevada County,Arkansas,421,26,49,75,Nevada 
50,Newton County,Arkansas,435,0,129,129,Newton 
51,Ouachita County,Arkansas,1035,18,2,20,Ouachita 
52,Perry County,Arkansas,481,18,22,40,Perry 
53,Phillips County,Arkansas,828,0,20,20,Phillips 
54,Pike County,Arkansas,600,0,5,5,Pike 
55,Poinsett County,Arkansas,1258,21,87,108,Poinsett 
56,Polk County,Arkansas,904,76,58,134,Polk 
57,Pope County,Arkansas,4575,88,224,312,Pope 
58,Prairie County,Arkansas,312,28,0,28,Prairie 
59,Pulaski County,Arkansas,17846,905,280,1185,Pulaski 
60,Randolph County,Arkansas,693,15,27,42,Randolph 
61,St. Francis County,Arkansas,1226,158,16,174,St. Francis 
62,Saline County,Arkansas,6146,280,164,444,Saline 
63,Scott County,Arkansas,452,26,27,53,Scott 
64,Searcy County,Arkansas,322,14,37,51,Searcy 
65,Sebastian County,Arkansas,6642,261,236,497,Sebastian 
66,Sevier County,Arkansas,841,12,21,33,Sevier 
67,Sharp County,Arkansas,749,51,0,51,Sharp 
68,Stone County,Arkansas,489,0,0,0,Stone 
69,Union County,Arkansas,1800,5,13,18,Union 
70,Van Buren County,Arkansas,805,0,84,84,Van Buren 
71,Washington County,Arkansas,15634,186,431,617,Washington 
72,White County,Arkansas,4997,191,101,292,White 
73,Woodruff County,Arkansas,296,0,6,6,Woodruff 
74,Yell County,Arkansas,1258,18,34,52,Yell 
0,Churchill County,Nevada,917,116,61,177,Churchill 
1,Clark County,Nevada,106298,4308,3320,7628,Clark 
2,Douglas County,Nevada,1962,68,15,83,Douglas 
3,Elko County,Nevada,2979,131,15,146,Elko 
4,Esmeralda County,Nevada,24,0,23,23,Esmeralda 
5,Eureka County,Nevada,129,65,0,65,Eureka 
6,Humboldt County,Nevada,906,51,45,96,Humboldt 
7,Lander County,Nevada,173,0,0,0,Lander 
8,Lincoln County,Nevada,296,28,0,28,Lincoln 
9,Lyon County,Nevada,2436,175,226,401,Lyon 
10,Mineral County,Nevada,321,0,64,64,Mineral 
11,Nye County,Nevada,1865,180,114,294,Nye 
12,Pershing County,Nevada,181,1,0,1,Pershing 
13,Storey County,Nevada,236,0,0,0,Storey 
14,Washoe County,Nevada,21901,999,552,1551,Washoe 
15,White Pine County,Nevada,251,12,4,16,White Pine 
16,Carson City,Nevada,2276,132,85,217,Carson City
0,Allen County,Kansas,783,23,13,36,Allen 
1,Anderson County,Kansas,324,30,32,62,Anderson 
2,Atchison County,Kansas,1085,54,50,104,Atchison 
3,Barber County,Kansas,161,8,0,8,Barber 
4,Barton County,Kansas,1307,42,44,86,Barton 
5,Bourbon County,Kansas,784,14,88,102,Bourbon 
6,Brown County,Kansas,461,0,18,18,Brown 
7,Butler County,Kansas,3968,140,86,226,Butler 
8,Chase County,Kansas,133,0,0,0,Chase 
9,Chautauqua County,Kansas,109,2,14,16,Chautauqua 
10,Cherokee County,Kansas,973,21,0,21,Cherokee 
11,Cheyenne County,Kansas,148,0,0,0,Cheyenne 
12,Clark County,Kansas,49,0,0,0,Clark 
13,Clay County,Kansas,253,4,6,10,Clay 
14,Cloud County,Kansas,389,3,31,34,Cloud 
15,Coffey County,Kansas,399,1,7,8,Coffey 
16,Comanche County,Kansas,84,0,0,0,Comanche 
17,Cowley County,Kansas,2139,69,30,99,Cowley 
18,Crawford County,Kansas,2671,124,16,140,Crawford 
19,Decatur County,Kansas,60,7,14,21,Decatur 
20,Dickinson County,Kansas,863,6,2,8,Dickinson 
21,Doniphan County,Kansas,764,6,0,6,Doniphan 
22,Douglas County,Kansas,9744,119,108,227,Douglas 
23,Edwards County,Kansas,104,9,0,9,Edwards 
24,Elk County,Kansas,83,0,1,1,Elk 
25,Ellis County,Kansas,1567,58,0,58,Ellis 
26,Ellsworth County,Kansas,286,0,0,0,Ellsworth 
27,Finney County,Kansas,2381,92,28,120,Finney 
28,Ford County,Kansas,2194,64,31,95,Ford 
29,Franklin County,Kansas,1511,10,16,26,Franklin 
30,Geary County,Kansas,1342,11,19,30,Geary 
31,Gove County,Kansas,64,0,3,3,Gove 
32,Graham County,Kansas,77,4,0,4,Graham 
33,Grant County,Kansas,419,70,0,70,Grant 
34,Gray County,Kansas,404,119,24,143,Gray 
35,Greeley County,Kansas,91,6,0,6,Greeley 
36,Greenwood County,Kansas,279,0,3,3,Greenwood 
37,Hamilton County,Kansas,147,0,12,12,Hamilton 
38,Harper County,Kansas,309,4,0,4,Harper 
39,Harvey County,Kansas,2222,178,172,350,Harvey 
40,Haskell County,Kansas,189,112,7,119,Haskell 
41,Hodgeman County,Kansas,106,0,0,0,Hodgeman 
42,Jackson County,Kansas,596,7,3,10,Jackson 
43,Jefferson County,Kansas,1051,30,0,30,Jefferson 
44,Jewell County,Kansas,94,0,0,0,Jewell 
45,Johnson County,Kansas,30368,666,260,926,Johnson 
46,Kearny County,Kansas,317,78,1,79,Kearny 
47,Kingman County,Kansas,306,44,0,44,Kingman 
48,Kiowa County,Kansas,215,0,0,0,Kiowa 
49,Labette County,Kansas,902,68,60,128,Labette 
50,Lane County,Kansas,118,54,59,113,Lane 
51,Leavenworth County,Kansas,4049,150,36,186,Leavenworth 
52,Lincoln County,Kansas,167,3,0,3,Lincoln 
53,Linn County,Kansas,422,14,54,68,Linn 
54,Logan County,Kansas,118,12,0,12,Logan 
55,Lyon County,Kansas,2148,23,34,57,Lyon 
56,McPherson County,Kansas,1665,128,78,206,McPherson 
57,Marion County,Kansas,674,44,26,70,Marion 
58,Marshall County,Kansas,439,35,4,39,Marshall 
59,Meade County,Kansas,232,14,0,14,Meade 
60,Miami County,Kansas,1774,0,18,18,Miami 
61,Mitchell County,Kansas,389,16,70,86,Mitchell 
62,Montgomery County,Kansas,1756,67,38,105,Montgomery 
63,Morris County,Kansas,207,0,0,0,Morris 
64,Morton County,Kansas,171,5,13,18,Morton 
65,Nemaha County,Kansas,588,5,0,5,Nemaha 
66,Neosho County,Kansas,966,6,0,6,Neosho 
67,Ness County,Kansas,102,6,0,6,Ness 
68,Norton County,Kansas,176,0,0,0,Norton 
69,Osage County,Kansas,761,41,36,77,Osage 
70,Osborne County,Kansas,88,0,7,7,Osborne 
71,Ottawa County,Kansas,315,21,13,34,Ottawa 
72,Pawnee County,Kansas,363,14,0,14,Pawnee 
73,Phillips County,Kansas,235,0,14,14,Phillips 
74,Pottawatomie County,Kansas,1398,71,16,87,Pottawatomie 
75,Pratt County,Kansas,634,1,0,1,Pratt 
76,Rawlins County,Kansas,61,1,0,1,Rawlins 
77,Reno County,Kansas,3155,153,176,329,Reno 
78,Republic County,Kansas,168,0,0,0,Republic 
79,Rice County,Kansas,605,4,0,4,Rice 
80,Riley County,Kansas,7028,112,75,187,Riley 
81,Rooks County,Kansas,237,6,1,7,Rooks 
82,Rush County,Kansas,98,0,10,10,Rush 
83,Russell County,Kansas,426,0,7,7,Russell 
84,Saline County,Kansas,2764,9,0,9,Saline 
85,Scott County,Kansas,248,4,0,4,Scott 
86,Sedgwick County,Kansas,26667,1459,902,2361,Sedgwick 
87,Seward County,Kansas,1257,122,9,131,Seward 
88,Shawnee County,Kansas,9112,322,157,479,Shawnee 
89,Sheridan County,Kansas,104,0,0,0,Sheridan 
90,Sherman County,Kansas,384,0,0,0,Sherman 
91,Smith County,Kansas,177,8,0,8,Smith 
92,Stafford County,Kansas,201,55,38,93,Stafford 
93,Stanton County,Kansas,108,0,0,0,Stanton 
94,Stevens County,Kansas,274,2,0,2,Stevens 
95,Sumner County,Kansas,1106,17,14,31,Sumner 
96,Thomas County,Kansas,505,11,1,12,Thomas 
97,Trego County,Kansas,103,0,3,3,Trego 
98,Wabaunsee County,Kansas,391,18,3,21,Wabaunsee 
99,Wallace County,Kansas,47,0,0,0,Wallace 
100,Washington County,Kansas,245,0,0,0,Washington 
101,Wichita County,Kansas,101,0,0,0,Wichita 
102,Wilson County,Kansas,474,54,42,96,Wilson 
103,Woodson County,Kansas,141,1,0,1,Woodson 
104,Wyandotte County,Kansas,8747,894,462,1356,Wyandotte 
0,Adair County,Kentucky,1349,54,13,67,Adair 
1,Allen County,Kentucky,872,131,38,169,Allen 
2,Anderson County,Kentucky,876,21,0,21,Anderson 
3,Ballard County,Kentucky,386,14,6,20,Ballard 
4,Barren County,Kentucky,2089,154,169,323,Barren 
5,Bath County,Kentucky,584,24,5,29,Bath 
6,Bell County,Kentucky,1242,81,62,143,Bell 
7,Boone County,Kentucky,7189,331,20,351,Boone 
8,Bourbon County,Kentucky,918,0,0,0,Bourbon 
9,Boyd County,Kentucky,2114,24,66,90,Boyd 
10,Boyle County,Kentucky,2187,0,22,22,Boyle 
11,Bracken County,Kentucky,359,0,71,71,Bracken 
12,Breathitt County,Kentucky,492,20,22,42,Breathitt 
13,Breckinridge County,Kentucky,1078,0,24,24,Breckinridge 
14,Bullitt County,Kentucky,4209,48,54,102,Bullitt 
15,Butler County,Kentucky,568,0,0,0,Butler 
16,Caldwell County,Kentucky,557,158,26,184,Caldwell 
17,Calloway County,Kentucky,3322,100,0,100,Calloway 
18,Campbell County,Kentucky,5330,33,0,33,Campbell 
19,Carlisle County,Kentucky,244,5,0,5,Carlisle 
20,Carroll County,Kentucky,440,0,0,0,Carroll 
21,Carter County,Kentucky,1215,53,70,123,Carter 
22,Casey County,Kentucky,763,51,184,235,Casey 
23,Christian County,Kentucky,3802,220,76,296,Christian 
24,Clark County,Kentucky,1426,185,19,204,Clark 
25,Clay County,Kentucky,756,12,56,68,Clay 
26,Clinton County,Kentucky,616,83,0,83,Clinton 
27,Crittenden County,Kentucky,347,29,10,39,Crittenden 
28,Cumberland County,Kentucky,222,0,23,23,Cumberland 
29,Daviess County,Kentucky,4602,288,124,412,Daviess 
30,Edmonson County,Kentucky,572,38,0,38,Edmonson 
31,Elliott County,Kentucky,232,0,3,3,Elliott 
32,Estill County,Kentucky,733,0,0,0,Estill 
33,Fayette County,Kentucky,18038,327,217,544,Fayette 
34,Fleming County,Kentucky,629,33,28,61,Fleming 
35,Floyd County,Kentucky,1722,65,23,88,Floyd 
36,Franklin County,Kentucky,2698,46,15,61,Franklin 
37,Fulton County,Kentucky,158,7,0,7,Fulton 
38,Gallatin County,Kentucky,545,19,0,19,Gallatin 
39,Garrard County,Kentucky,718,0,0,0,Garrard 
40,Grant County,Kentucky,1460,147,18,165,Grant 
41,Graves County,Kentucky,2089,32,132,164,Graves 
42,Grayson County,Kentucky,1358,151,40,191,Grayson 
43,Green County,Kentucky,438,32,0,32,Green 
44,Greenup County,Kentucky,1680,52,11,63,Greenup 
45,Hancock County,Kentucky,500,0,26,26,Hancock 
46,Hardin County,Kentucky,5668,200,131,331,Hardin 
47,Harlan County,Kentucky,1134,37,64,101,Harlan 
48,Harrison County,Kentucky,810,0,40,40,Harrison 
49,Hart County,Kentucky,908,159,66,225,Hart 
50,Henderson County,Kentucky,2378,74,34,108,Henderson 
51,Henry County,Kentucky,928,32,12,44,Henry 
52,Hickman County,Kentucky,295,14,0,14,Hickman 
53,Hopkins County,Kentucky,2173,47,19,66,Hopkins 
54,Jackson County,Kentucky,727,25,0,25,Jackson 
55,Jefferson County,Kentucky,36926,1221,1184,2405,Jefferson 
56,Jessamine County,Kentucky,2967,54,47,101,Jessamine 
57,Johnson County,Kentucky,989,33,0,33,Johnson 
58,Kenton County,Kentucky,7802,109,32,141,Kenton 
59,Knott County,Kentucky,839,49,0,49,Knott 
60,Knox County,Kentucky,1801,0,44,44,Knox 
61,Larue County,Kentucky,646,23,13,36,Larue 
62,Laurel County,Kentucky,2941,168,205,373,Laurel 
63,Lawrence County,Kentucky,708,12,26,38,Lawrence 
64,Lee County,Kentucky,400,14,27,41,Lee 
65,Leslie County,Kentucky,229,0,23,23,Leslie 
66,Letcher County,Kentucky,917,9,68,77,Letcher 
67,Lewis County,Kentucky,656,0,0,0,Lewis 
68,Lincoln County,Kentucky,1171,61,66,127,Lincoln 
69,Livingston County,Kentucky,386,31,0,31,Livingston 
70,Logan County,Kentucky,1143,86,94,180,Logan 
71,Lyon County,Kentucky,321,0,0,0,Lyon 
72,McCracken County,Kentucky,2825,111,83,194,McCracken 
73,McCreary County,Kentucky,799,79,0,79,McCreary 
74,McLean County,Kentucky,481,10,10,20,McLean 
75,Madison County,Kentucky,7081,102,70,172,Madison 
76,Magoffin County,Kentucky,451,22,6,28,Magoffin 
77,Marion County,Kentucky,911,73,8,81,Marion 
78,Marshall County,Kentucky,1412,28,0,28,Marshall 
79,Martin County,Kentucky,493,50,24,74,Martin 
80,Mason County,Kentucky,791,4,105,109,Mason 
81,Meade County,Kentucky,1422,16,59,75,Meade 
82,Menifee County,Kentucky,196,10,6,16,Menifee 
83,Mercer County,Kentucky,1045,37,8,45,Mercer 
84,Metcalfe County,Kentucky,439,11,0,11,Metcalfe 
85,Monroe County,Kentucky,505,217,0,217,Monroe 
86,Montgomery County,Kentucky,1421,3,22,25,Montgomery 
87,Morgan County,Kentucky,578,95,27,122,Morgan 
88,Muhlenberg County,Kentucky,1745,10,38,48,Muhlenberg 
89,Nelson County,Kentucky,2051,3,17,20,Nelson 
90,Nicholas County,Kentucky,416,20,0,20,Nicholas 
91,Ohio County,Kentucky,1314,83,8,91,Ohio 
92,Oldham County,Kentucky,3618,32,48,80,Oldham 
93,Owen County,Kentucky,448,0,37,37,Owen 
94,Owsley County,Kentucky,255,17,8,25,Owsley 
95,Pendleton County,Kentucky,685,18,0,18,Pendleton 
96,Perry County,Kentucky,1321,0,0,0,Perry 
97,Pike County,Kentucky,2815,35,56,91,Pike 
98,Powell County,Kentucky,416,5,0,5,Powell 
99,Pulaski County,Kentucky,2910,352,63,415,Pulaski 
100,Robertson County,Kentucky,88,4,8,12,Robertson 
101,Rockcastle County,Kentucky,887,0,0,0,Rockcastle 
102,Rowan County,Kentucky,2743,0,21,21,Rowan 
103,Russell County,Kentucky,842,63,6,69,Russell 
104,Scott County,Kentucky,2936,74,8,82,Scott 
105,Shelby County,Kentucky,2440,62,16,78,Shelby 
106,Simpson County,Kentucky,890,0,7,7,Simpson 
107,Spencer County,Kentucky,1099,0,50,50,Spencer 
108,Taylor County,Kentucky,1678,72,50,122,Taylor 
109,Todd County,Kentucky,623,145,115,260,Todd 
110,Trigg County,Kentucky,886,44,24,68,Trigg 
111,Trimble County,Kentucky,484,0,20,20,Trimble 
112,Union County,Kentucky,855,141,11,152,Union 
113,Warren County,Kentucky,10305,143,0,143,Warren 
114,Washington County,Kentucky,598,8,27,35,Washington 
115,Wayne County,Kentucky,930,102,10,112,Wayne 
116,Webster County,Kentucky,588,32,36,68,Webster 
117,Whitley County,Kentucky,2262,14,99,113,Whitley 
118,Wolfe County,Kentucky,345,1,0,1,Wolfe 
119,Woodford County,Kentucky,1533,31,97,128,Woodford 
0,Bernalillo County,New Mexico,34511,1483,1280,2763,Bernalillo 
1,Catron County,New Mexico,186,0,0,0,Catron 
2,Chaves County,New Mexico,4146,317,191,508,Chaves 
3,Cibola County,New Mexico,1521,60,20,80,Cibola 
4,Colfax County,New Mexico,544,4,113,117,Colfax 
5,Curry County,New Mexico,2790,267,45,312,Curry 
6,De Baca County,New Mexico,283,0,0,0,De Baca 
7,Doña Ana County,New Mexico,14450,346,382,728,Doña Ana 
8,Eddy County,New Mexico,3241,408,407,815,Eddy 
9,Grant County,New Mexico,1382,8,19,27,Grant 
10,Guadalupe County,New Mexico,52,0,0,0,Guadalupe 
11,Harding County,New Mexico,7,0,0,0,Harding 
12,Hidalgo County,New Mexico,131,0,21,21,Hidalgo 
13,Lea County,New Mexico,4498,311,131,442,Lea 
14,Lincoln County,New Mexico,670,53,6,59,Lincoln 
15,Los Alamos County,New Mexico,960,0,40,40,Los Alamos 
16,Luna County,New Mexico,1244,63,74,137,Luna 
17,McKinley County,New Mexico,4510,301,276,577,McKinley 
18,Mora County,New Mexico,116,0,0,0,Mora 
19,Otero County,New Mexico,3494,262,201,463,Otero 
20,Quay County,New Mexico,218,2,2,4,Quay 
21,Rio Arriba County,New Mexico,2231,116,67,183,Rio Arriba 
22,Roosevelt County,New Mexico,1328,91,2,93,Roosevelt 
23,Sandoval County,New Mexico,7647,189,138,327,Sandoval 
24,San Juan County,New Mexico,7185,317,293,610,San Juan 
25,San Miguel County,New Mexico,1904,50,26,76,San Miguel 
26,Santa Fe County,New Mexico,6636,184,405,589,Santa Fe 
27,Sierra County,New Mexico,360,14,2,16,Sierra 
28,Socorro County,New Mexico,1031,17,0,17,Socorro 
29,Taos County,New Mexico,1335,0,122,122,Taos 
30,Torrance County,New Mexico,1048,80,42,122,Torrance 
31,Union County,New Mexico,42,0,0,0,Union 
32,Valencia County,New Mexico,4343,293,87,380,Valencia 
